"Name","K","Kin","Kout","TypeI","TypeII","weight","Type"
"PIK3CA",54,46,8,0,1,381,"coding"
"GATA3",435,24,411,0,1,104,"coding"
"DMD",51,45,6,0,1,56,"coding"
"LRP2",21,12,9,0,1,39,"coding"
"PTEN",91,84,7,0,1,39,"coding"
"APOB",6,4,2,0,1,38,"coding"
"RUNX1",540,86,454,0,1,34,"coding"
"LRP1",48,37,11,0,1,33,"coding"
"RYR1",6,3,3,0,1,30,"coding"
"ANK2",21,20,1,0,1,29,"coding"
"ANK3",41,39,2,0,1,28,"coding"
"AKAP9",33,29,4,0,1,27,"coding"
"LYST",26,23,3,0,1,27,"coding"
"NOTCH2",81,71,10,0,1,27,"coding"
"FLNA",57,48,9,0,1,24,"coding"
"MED12",14,12,2,0,1,24,"coding"
"RPGR",3,2,1,0,1,24,"coding"
"VCAN",69,59,10,0,1,24,"coding"
"RB1",127,103,24,0,1,23,"coding"
"LAMA1",19,11,8,0,1,21,"coding"
"BRCA2",19,15,4,0,1,19,"coding"
"HDAC6",12,11,1,0,1,18,"coding"
"PIK3R1",133,86,47,0,1,18,"coding"
"SF3B1",51,45,6,0,1,18,"coding"
"CHD3",45,34,11,0,1,16,"coding"
"HSPG2",32,26,6,0,1,16,"coding"
"PCSK5",33,31,2,0,1,16,"coding"
"PTPN13",28,24,4,0,1,16,"coding"
"SPTAN1",24,17,7,0,1,16,"coding"
"ATN1",52,35,17,0,1,15,"coding"
"CBLB",47,39,8,0,1,15,"coding"
"CNKSR2",22,19,3,0,1,15,"coding"
"CREBBP",280,84,196,0,1,15,"coding"
"GRIK2",18,17,1,0,1,15,"coding"
"CFTR",10,8,2,0,1,14,"coding"
"EP300",161,143,18,0,1,14,"coding"
"HTT",58,48,10,0,1,14,"coding"
"NUP98",51,45,6,0,1,14,"coding"
"TOPBP1",25,22,3,0,1,14,"coding"
"TSC22D1",37,33,4,0,1,14,"coding"
"UBC",28,22,6,0,1,14,"coding"
"ARHGEF12",52,46,6,0,1,13,"coding"
"ATR",19,14,5,0,1,13,"coding"
"CASP8",64,42,22,0,1,13,"coding"
"FN1",97,77,20,0,1,13,"coding"
"MAP3K5",47,34,13,0,1,13,"coding"
"MYO15A",2,1,1,0,1,13,"coding"
"NOS1",21,16,5,0,1,13,"coding"
"ABCA1",56,52,4,0,1,12,"coding"
"IKBKAP",29,25,4,0,1,12,"coding"
"JAK1",68,46,22,0,1,12,"coding"
"NID1",37,35,2,0,1,12,"coding"
"PLXNA1",43,40,3,0,1,12,"coding"
"AP3B1",39,36,3,0,1,11,"coding"
"BACH2",95,73,22,0,1,11,"coding"
"EPRS",20,18,2,0,1,11,"coding"
"GPRASP1",18,6,12,0,1,11,"coding"
"GPRASP2",16,6,10,0,1,11,"coding"
"INSR",54,33,21,0,1,11,"coding"
"MYLK",71,67,4,0,1,11,"coding"
"NEDD9",31,29,2,0,1,11,"coding"
"NLGN3",11,9,2,0,1,11,"coding"
"PRKCQ",15,8,7,0,1,11,"coding"
"SMARCA4",56,22,34,0,1,11,"coding"
"XRN1",68,61,7,0,1,11,"coding"
"AFF1",62,55,7,0,1,10,"coding"
"ARHGEF1",24,20,4,0,1,10,"coding"
"COL3A1",37,33,4,0,1,10,"coding"
"COL4A4",34,27,7,0,1,10,"coding"
"DIAPH2",40,39,1,0,1,10,"coding"
"HIPK2",53,49,4,0,1,10,"coding"
"ITSN1",53,44,9,0,1,10,"coding"
"MARK2",40,39,1,0,1,10,"coding"
"MET",52,33,19,0,1,10,"coding"
"PROX1",68,55,13,0,1,10,"coding"
"SH3KBP1",44,39,5,0,1,10,"coding"
"SHANK1",13,3,10,0,1,10,"coding"
"UBR1",36,27,9,0,1,10,"coding"
"APBA1",34,31,3,0,1,9,"coding"
"APP",135,111,24,0,1,9,"coding"
"ATXN1",167,143,24,0,1,9,"coding"
"CASK",46,34,12,0,1,9,"coding"
"CHUK",50,35,15,0,1,9,"coding"
"COL4A2",40,37,3,0,1,9,"coding"
"CP",2,1,1,0,1,9,"coding"
"CUL9",7,5,2,0,1,9,"coding"
"EWSR1",46,30,16,0,1,9,"coding"
"FLII",12,9,3,0,1,9,"coding"
"IL6ST",83,80,3,0,1,9,"coding"
"ITGB2",26,9,17,0,1,9,"coding"
"KIAA1377",30,16,14,0,1,9,"coding"
"NACA",14,13,1,0,1,9,"coding"
"NTRK1",11,3,8,0,1,9,"coding"
"PIK3CB",49,41,8,0,1,9,"coding"
"PRKCE",51,40,11,0,1,9,"coding"
"RGS3",18,15,3,0,1,9,"coding"
"RPS6KA3",93,84,9,0,1,9,"coding"
"RTN4",51,44,7,0,1,9,"coding"
"STAT4",18,5,13,0,1,9,"coding"
"USP8",21,19,2,0,1,9,"coding"
"A2M",22,11,11,0,1,8,"coding"
"ABL1",68,44,24,0,1,8,"coding"
"ACTG1",65,50,15,0,1,8,"coding"
"ARHGEF7",35,30,5,0,1,8,"coding"
"BMPR2",81,69,12,0,1,8,"coding"
"CACHD1",22,20,2,0,1,8,"coding"
"CAPN1",26,19,7,0,1,8,"coding"
"COL1A1",64,53,11,0,1,8,"coding"
"CREB3L3",3,1,2,0,1,8,"coding"
"DLGAP4",26,24,2,0,1,8,"coding"
"EEF1A1",64,50,14,0,1,8,"coding"
"IARS",28,27,1,0,1,8,"coding"
"IRF3",38,16,22,0,1,8,"coding"
"JAK3",27,18,9,0,1,8,"coding"
"KDR",45,25,20,0,1,8,"coding"
"KIT",64,40,24,0,1,8,"coding"
"MAPK8IP3",38,27,11,0,1,8,"coding"
"MCM10",29,22,7,0,1,8,"coding"
"NCOR2",93,55,38,0,1,8,"coding"
"NFE2L1",62,61,1,0,1,8,"coding"
"NOTCH1",40,37,3,0,1,8,"coding"
"NR1H2",53,12,41,0,1,8,"coding"
"NUAK1",45,41,4,0,1,8,"coding"
"PDGFRB",41,20,21,0,1,8,"coding"
"PLCG1",92,65,27,0,1,8,"coding"
"PLD1",36,32,4,0,1,8,"coding"
"POLR2B",27,26,1,0,1,8,"coding"
"PRKD2",32,28,4,0,1,8,"coding"
"PTK2",60,39,21,0,1,8,"coding"
"PTPN12",43,41,2,0,1,8,"coding"
"PTPRC",30,20,10,0,1,8,"coding"
"RAD50",25,22,3,0,1,8,"coding"
"RFC1",18,16,2,0,1,8,"coding"
"RREB1",96,94,2,0,1,8,"coding"
"SYNCRIP",94,92,2,0,1,8,"coding"
"TEK",16,9,7,0,1,8,"coding"
"THBS1",109,100,9,0,1,8,"coding"
"TJP1",57,46,11,0,1,8,"coding"
"USP13",24,20,4,0,1,8,"coding"
"ACTN4",58,55,3,0,1,7,"coding"
"AXIN1",37,20,17,0,1,7,"coding"
"BCAR1",37,29,8,0,1,7,"coding"
"BTK",41,7,34,0,1,7,"coding"
"CRMP1",23,16,7,0,1,7,"coding"
"DNM2",52,43,9,0,1,7,"coding"
"DPP4",18,11,7,0,1,7,"coding"
"EPS8",42,35,7,0,1,7,"coding"
"FEZ1",19,6,13,0,1,7,"coding"
"FMR1",50,48,2,0,1,7,"coding"
"HDAC4",46,42,4,0,1,7,"coding"
"IGF1R",158,145,13,0,1,7,"coding"
"IL16",18,16,2,0,1,7,"coding"
"ITGAV",44,35,9,0,1,7,"coding"
"JAK2",57,32,25,0,1,7,"coding"
"JUP",26,22,4,0,1,7,"coding"
"KTN1",26,23,3,0,1,7,"coding"
"LDLR",75,73,2,0,1,7,"coding"
"LEPR",24,14,10,0,1,7,"coding"
"LNX1",13,7,6,0,1,7,"coding"
"MCM7",57,48,9,0,1,7,"coding"
"MEIS1",48,40,8,0,1,7,"coding"
"PCM1",25,23,2,0,1,7,"coding"
"PHC2",31,27,4,0,1,7,"coding"
"PIAS2",35,32,3,0,1,7,"coding"
"PIGR",26,25,1,0,1,7,"coding"
"PLA2G4A",40,31,9,0,1,7,"coding"
"POLR2A",71,60,11,0,1,7,"coding"
"PPARGC1A",54,53,1,0,1,7,"coding"
"PRKCB",59,46,13,0,1,7,"coding"
"PTK2B",41,22,19,0,1,7,"coding"
"RFX1",39,33,6,0,1,7,"coding"
"RHOA",59,47,12,0,1,7,"coding"
"SPRED1",91,90,1,0,1,7,"coding"
"SPTBN4",26,21,5,0,1,7,"coding"
"TGM2",21,15,6,0,1,7,"coding"
"TP53BP2",33,30,3,0,1,7,"coding"
"TRIM24",37,29,8,0,1,7,"coding"
"WRN",36,33,3,0,1,7,"coding"
"WWP1",26,21,5,0,1,7,"coding"
"ABL2",117,114,3,0,1,6,"coding"
"ACTN1",50,41,9,0,1,6,"coding"
"ADRBK1",39,26,13,0,1,6,"coding"
"AP2A1",34,28,6,0,1,6,"coding"
"ARAF",14,12,2,0,1,6,"coding"
"ARHGEF11",18,16,2,0,1,6,"coding"
"ARHGEF6",25,19,6,0,1,6,"coding"
"ATF7IP",78,60,18,0,1,6,"coding"
"BMPR1B",23,11,12,0,1,6,"coding"
"CCNT1",57,56,1,0,1,6,"coding"
"CLTC",93,79,14,0,1,6,"coding"
"CNKSR1",5,3,2,0,1,6,"coding"
"COL4A3",29,27,2,0,1,6,"coding"
"CSE1L",55,52,3,0,1,6,"coding"
"DISC1",32,31,1,0,1,6,"coding"
"EBF1",218,33,185,0,1,6,"coding"
"EPHB2",39,31,8,0,1,6,"coding"
"FLI1",353,23,330,0,1,6,"coding"
"GNAZ",12,10,2,0,1,6,"coding"
"GSK3A",15,14,1,0,1,6,"coding"
"HGS",33,17,16,0,1,6,"coding"
"HSPA8",77,63,14,0,1,6,"coding"
"HSPD1",46,42,4,0,1,6,"coding"
"ITGA4",20,17,3,0,1,6,"coding"
"KAT2B",59,54,5,0,1,6,"coding"
"LYN",100,63,37,0,1,6,"coding"
"MAPK6",129,98,31,0,1,6,"coding"
"MEF2A",80,38,42,0,1,6,"coding"
"MEP1A",2,1,1,0,1,6,"coding"
"MYBL2",97,25,72,0,1,6,"coding"
"NCOA2",72,59,13,0,1,6,"coding"
"NEDD4",54,50,4,0,1,6,"coding"
"NEK9",75,74,1,0,1,6,"coding"
"NFKB2",82,13,69,0,1,6,"coding"
"PIK3R3",56,52,4,0,1,6,"coding"
"PIP4K2C",37,33,4,0,1,6,"coding"
"POLA2",39,35,4,0,1,6,"coding"
"PPFIA3",26,23,3,0,1,6,"coding"
"PPP3CA",44,38,6,0,1,6,"coding"
"PRKAR1A",71,59,12,0,1,6,"coding"
"PRKD1",36,30,6,0,1,6,"coding"
"RBL1",64,59,5,0,1,6,"coding"
"RGS4",21,19,2,0,1,6,"coding"
"RIPK1",12,10,2,0,1,6,"coding"
"SH3D19",60,58,2,0,1,6,"coding"
"SMURF2",74,57,17,0,1,6,"coding"
"SRRM1",17,13,4,0,1,6,"coding"
"STAU1",43,36,7,0,1,6,"coding"
"TARBP2",33,30,3,0,1,6,"coding"
"TCOF1",21,20,1,0,1,6,"coding"
"UBQLN4",27,19,8,0,1,6,"coding"
"VCL",137,108,29,0,1,6,"coding"
"WAS",22,11,11,0,1,6,"coding"
"WASF1",24,22,2,0,1,6,"coding"
"ABCF3",26,25,1,0,1,5,"coding"
"ACTB",119,96,23,0,1,5,"coding"
"AGT",7,3,4,0,1,5,"coding"
"AKT2",45,37,8,0,1,5,"coding"
"ANXA1",16,9,7,0,1,5,"coding"
"BCR",26,22,4,0,1,5,"coding"
"BUB1B",12,10,2,0,1,5,"coding"
"CSF2RB",19,9,10,0,1,5,"coding"
"CSNK1E",63,60,3,0,1,5,"coding"
"DIS3",24,21,3,0,1,5,"coding"
"EGFR",114,68,46,0,1,5,"coding"
"EPB41",80,65,15,0,1,5,"coding"
"ERCC3",14,13,1,0,1,5,"coding"
"F10",9,8,1,0,1,5,"coding"
"FXR2",36,27,9,0,1,5,"coding"
"GAB2",29,27,2,0,1,5,"coding"
"GGA1",39,34,5,0,1,5,"coding"
"GOLGA2",31,25,6,0,1,5,"coding"
"HOOK2",10,8,2,0,1,5,"coding"
"HSPA5",40,33,7,0,1,5,"coding"
"IRAK1",45,27,18,0,1,5,"coding"
"ITGB1",87,57,30,0,1,5,"coding"
"ITGB7",9,3,6,0,1,5,"coding"
"LRSAM1",17,12,5,0,1,5,"coding"
"LUC7L2",66,58,8,0,1,5,"coding"
"MED25",10,6,4,0,1,5,"coding"
"MINK1",70,67,3,0,1,5,"coding"
"MYBBP1A",15,14,1,0,1,5,"coding"
"NCOA1",121,79,42,0,1,5,"coding"
"NFKB1",156,26,130,0,1,5,"coding"
"PKD2",23,21,2,0,1,5,"coding"
"PNN",29,26,3,0,1,5,"coding"
"PORCN",9,7,2,0,1,5,"coding"
"PRKG1",50,37,13,0,1,5,"coding"
"PRPF40A",90,74,16,0,1,5,"coding"
"PTGDS",6,4,2,0,1,5,"coding"
"RNF19A",40,32,8,0,1,5,"coding"
"SCARB1",15,14,1,0,1,5,"coding"
"SOX10",19,7,12,0,1,5,"coding"
"SYK",60,26,34,0,1,5,"coding"
"TOP1",29,27,2,0,1,5,"coding"
"TRIM37",75,68,7,0,1,5,"coding"
"TRPC3",27,20,7,0,1,5,"coding"
"ZNF417",69,67,2,0,1,5,"coding"
"AKAP8L",15,11,4,0,1,4,"coding"
"AP2B1",51,41,10,0,1,4,"coding"
"AP2M1",25,23,2,0,1,4,"coding"
"ARNT",52,27,25,0,1,4,"coding"
"BICD2",74,72,2,0,1,4,"coding"
"BUB1",58,53,5,0,1,4,"coding"
"CAMK2A",38,35,3,0,1,4,"coding"
"CANX",79,70,9,0,1,4,"coding"
"CAV1",89,64,25,0,1,4,"coding"
"CBL",111,84,27,0,1,4,"coding"
"CCR1",10,8,2,0,1,4,"coding"
"CD2",12,8,4,0,1,4,"coding"
"CD244",12,10,2,0,1,4,"coding"
"CD4",45,33,12,0,1,4,"coding"
"CD44",26,23,3,0,1,4,"coding"
"DCTN1",18,14,4,0,1,4,"coding"
"ETS1",313,64,249,0,1,4,"coding"
"FGFR3",33,19,14,0,1,4,"coding"
"GIT1",50,38,12,0,1,4,"coding"
"GNA11",19,14,5,0,1,4,"coding"
"GRB7",14,9,5,0,1,4,"coding"
"HAND2",76,29,47,0,1,4,"coding"
"HIPK3",115,109,6,0,1,4,"coding"
"HTRA1",18,12,6,0,1,4,"coding"
"IMMT",16,12,4,0,1,4,"coding"
"INPP5D",15,8,7,0,1,4,"coding"
"ITCH",29,25,4,0,1,4,"coding"
"ITGB5",26,16,10,0,1,4,"coding"
"KPNA2",55,53,2,0,1,4,"coding"
"KPNB1",86,74,12,0,1,4,"coding"
"MAD1L1",8,6,2,0,1,4,"coding"
"MAGEA11",8,4,4,0,1,4,"coding"
"MAP3K7",69,62,7,0,1,4,"coding"
"MED1",53,47,6,0,1,4,"coding"
"MEGF10",5,4,1,0,1,4,"coding"
"MEOX2",18,17,1,0,1,4,"coding"
"MMP14",33,24,9,0,1,4,"coding"
"MMP2",59,42,17,0,1,4,"coding"
"MPP3",13,12,1,0,1,4,"coding"
"NCF4",6,5,1,0,1,4,"coding"
"NEUROD1",31,27,4,0,1,4,"coding"
"NFATC2",38,32,6,0,1,4,"coding"
"PAK1",16,15,1,0,1,4,"coding"
"PAX3",29,28,1,0,1,4,"coding"
"PAX6",26,24,2,0,1,4,"coding"
"PDCD6IP",38,27,11,0,1,4,"coding"
"PDLIM7",14,10,4,0,1,4,"coding"
"PIK3R2",13,8,5,0,1,4,"coding"
"PKN1",19,16,3,0,1,4,"coding"
"PLAU",18,14,4,0,1,4,"coding"
"PRKACA",29,13,16,0,1,4,"coding"
"PRKCA",120,65,55,0,1,4,"coding"
"RAF1",48,38,10,0,1,4,"coding"
"RPS6KA5",71,66,5,0,1,4,"coding"
"SAFB",26,20,6,0,1,4,"coding"
"SCMH1",6,5,1,0,1,4,"coding"
"SDCBP2",2,1,1,0,1,4,"coding"
"SFPQ",229,60,169,0,1,4,"coding"
"SGSM2",33,29,4,0,1,4,"coding"
"SHC1",47,30,17,0,1,4,"coding"
"SIAH1",31,29,2,0,1,4,"coding"
"SMAD3",138,34,104,0,1,4,"coding"
"STX6",72,68,4,0,1,4,"coding"
"TCF3",513,23,490,0,1,4,"coding"
"TGFBR1",124,84,40,0,1,4,"coding"
"TGFBR2",111,99,12,0,1,4,"coding"
"TMPO",47,43,4,0,1,4,"coding"
"TNFRSF1A",34,15,19,0,1,4,"coding"
"TRAF3",43,38,5,0,1,4,"coding"
"TRAF6",77,50,27,0,1,4,"coding"
"TRIM23",28,25,3,0,1,4,"coding"
"TRIM39",11,10,1,0,1,4,"coding"
"UBE3A",55,50,5,0,1,4,"coding"
"WBP11",23,18,5,0,1,4,"coding"
"WT1",30,26,4,0,1,4,"coding"
"XRCC6",67,60,7,0,1,4,"coding"
"XRN2",19,15,4,0,1,4,"coding"
"ZFYVE9",42,39,3,0,1,4,"coding"
"ADAM10",51,49,2,0,1,3,"coding"
"ALB",6,4,2,0,1,3,"coding"
"APPL1",47,41,6,0,1,3,"coding"
"ASF1A",38,37,1,0,1,3,"coding"
"B2M",40,37,3,0,1,3,"coding"
"BIRC2",28,17,11,0,1,3,"coding"
"BLOC1S2",24,23,1,0,1,3,"coding"
"CASP1",20,12,8,0,1,3,"coding"
"CASP9",21,17,4,0,1,3,"coding"
"CD3E",18,13,5,0,1,3,"coding"
"CD5",15,12,3,0,1,3,"coding"
"CDC37",45,40,5,0,1,3,"coding"
"CHMP2A",12,10,2,0,1,3,"coding"
"COPS6",53,36,17,0,1,3,"coding"
"CSNK2A1",141,119,22,0,1,3,"coding"
"CTGF",44,42,2,0,1,3,"coding"
"CTNNB1",112,95,17,0,1,3,"coding"
"DLG3",25,17,8,0,1,3,"coding"
"DNMT3B",33,18,15,0,1,3,"coding"
"E2F3",218,109,109,0,1,3,"coding"
"EFEMP2",21,18,3,0,1,3,"coding"
"EFNA3",31,30,1,0,1,3,"coding"
"FES",10,8,2,0,1,3,"coding"
"FGFR1",43,39,4,0,1,3,"coding"
"GNAI2",44,36,8,0,1,3,"coding"
"GOPC",32,27,5,0,1,3,"coding"
"GP1BA",5,4,1,0,1,3,"coding"
"GRK6",28,23,5,0,1,3,"coding"
"GTF2E2",14,11,3,0,1,3,"coding"
"HEXDC",5,3,2,0,1,3,"coding"
"HSP90AA1",84,66,18,0,1,3,"coding"
"HSP90B1",53,49,4,0,1,3,"coding"
"ICAM3",6,4,2,0,1,3,"coding"
"ILK",32,23,9,0,1,3,"coding"
"KCNA3",7,5,2,0,1,3,"coding"
"KIAA1279",24,20,4,0,1,3,"coding"
"LCP2",25,17,8,0,1,3,"coding"
"LGALS3",16,13,3,0,1,3,"coding"
"MAP3K2",100,98,2,0,1,3,"coding"
"MAPK8",98,91,7,0,1,3,"coding"
"MBD3",459,36,423,0,1,3,"coding"
"MBP",18,8,10,0,1,3,"coding"
"MDM2",113,107,6,0,1,3,"coding"
"MELK",53,52,1,0,1,3,"coding"
"PCYT2",15,14,1,0,1,3,"coding"
"PDCD10",30,29,1,0,1,3,"coding"
"PHYHIP",33,28,5,0,1,3,"coding"
"PIAS4",47,45,2,0,1,3,"coding"
"PICK1",17,6,11,0,1,3,"coding"
"PITX1",13,12,1,0,1,3,"coding"
"PML",19,13,6,0,1,3,"coding"
"PNKP",6,4,2,0,1,3,"coding"
"PPP2CA",69,62,7,0,1,3,"coding"
"PRKAR2A",71,65,6,0,1,3,"coding"
"PRKCG",12,5,7,0,1,3,"coding"
"PSMD4",12,10,2,0,1,3,"coding"
"PTGES3",33,32,1,0,1,3,"coding"
"RAB11A",46,43,3,0,1,3,"coding"
"RAD23A",21,17,4,0,1,3,"coding"
"RANBP10",14,13,1,0,1,3,"coding"
"RINT1",9,7,2,0,1,3,"coding"
"SERPING1",26,22,4,0,1,3,"coding"
"SH3GL2",22,20,2,0,1,3,"coding"
"SKIL",122,98,24,0,1,3,"coding"
"SLC9A3R1",27,18,9,0,1,3,"coding"
"STX4",36,30,6,0,1,3,"coding"
"SUMO1",70,66,4,0,1,3,"coding"
"TAF4",31,27,4,0,1,3,"coding"
"TNNT1",11,6,5,0,1,3,"coding"
"TRADD",17,9,8,0,1,3,"coding"
"TRAF4",27,23,4,0,1,3,"coding"
"TRAF5",17,15,2,0,1,3,"coding"
"TRIP6",20,14,6,0,1,3,"coding"
"TUBB2B",10,7,3,0,1,3,"coding"
"UPF1",29,24,5,0,1,3,"coding"
"VTN",13,4,9,0,1,3,"coding"
"WIPF1",31,27,4,0,1,3,"coding"
"XAB2",8,4,4,0,1,3,"coding"
"XRCC5",51,45,6,0,1,3,"coding"
"YWHAZ",171,126,45,0,1,3,"coding"
"ZAP70",32,4,28,0,1,3,"coding"
"ZBTB43",61,60,1,0,1,3,"coding"
"AKT1",79,53,26,0,1,2,"coding"
"ANXA7",56,46,10,0,1,2,"coding"
"APPBP2",46,43,3,0,1,2,"coding"
"ARIH2",37,36,1,0,1,2,"coding"
"ARRB2",32,24,8,0,1,2,"coding"
"BAIAP2",15,10,5,0,1,2,"coding"
"BDNF",23,21,2,0,1,2,"coding"
"BMI1",44,41,3,0,1,2,"coding"
"BMP4",12,10,2,0,1,2,"coding"
"C11orf58",32,29,3,0,1,2,"coding"
"CALCOCO2",37,30,7,0,1,2,"coding"
"CALR",64,56,8,0,1,2,"coding"
"CASP7",23,21,2,0,1,2,"coding"
"CCL21",4,2,2,0,1,2,"coding"
"CCR3",11,5,6,0,1,2,"coding"
"CD28",45,33,12,0,1,2,"coding"
"CD2AP",97,93,4,0,1,2,"coding"
"CD9",5,4,1,0,1,2,"coding"
"CDH2",43,38,5,0,1,2,"coding"
"CDK2",94,87,7,0,1,2,"coding"
"CDK5",33,27,6,0,1,2,"coding"
"CPE",41,38,3,0,1,2,"coding"
"CREB1",438,81,357,0,1,2,"coding"
"CRY1",8,5,3,0,1,2,"coding"
"CTTN",36,32,4,0,1,2,"coding"
"DAG1",41,37,4,0,1,2,"coding"
"DAXX",19,16,3,0,1,2,"coding"
"DCN",21,14,7,0,1,2,"coding"
"DPPA4",7,4,3,0,1,2,"coding"
"E2F6",451,40,411,0,1,2,"coding"
"EDA",5,4,1,0,1,2,"coding"
"EFNA4",7,6,1,0,1,2,"coding"
"EFNB2",52,46,6,0,1,2,"coding"
"EMD",23,20,3,0,1,2,"coding"
"GABARAP",22,19,3,0,1,2,"coding"
"GATA1",438,4,434,0,1,2,"coding"
"GBP2",17,11,6,0,1,2,"coding"
"GDI2",27,26,1,0,1,2,"coding"
"GNA12",27,21,6,0,1,2,"coding"
"GNAI1",33,26,7,0,1,2,"coding"
"GNAO1",25,18,7,0,1,2,"coding"
"GNB5",37,36,1,0,1,2,"coding"
"GRAP2",47,41,6,0,1,2,"coding"
"GRASP",9,8,1,0,1,2,"coding"
"GRK5",33,27,6,0,1,2,"coding"
"GSK3B",139,103,36,0,1,2,"coding"
"GTF2E1",24,23,1,0,1,2,"coding"
"GTF2H1",40,36,4,0,1,2,"coding"
"HDHD2",11,9,2,0,1,2,"coding"
"HNRNPK",53,42,11,0,1,2,"coding"
"HRAS",46,25,21,0,1,2,"coding"
"IGSF21",9,6,3,0,1,2,"coding"
"IL12B",6,5,1,0,1,2,"coding"
"IL21",2,1,1,0,1,2,"coding"
"IL2RG",10,8,2,0,1,2,"coding"
"KCNA2",10,8,2,0,1,2,"coding"
"LCK",63,34,29,0,1,2,"coding"
"LSM5",15,10,5,0,1,2,"coding"
"MAPK14",94,83,11,0,1,2,"coding"
"MAPK3",49,38,11,0,1,2,"coding"
"MAPK8IP2",31,21,10,0,1,2,"coding"
"MMP1",14,11,3,0,1,2,"coding"
"MRFAP1",28,26,2,0,1,2,"coding"
"NMI",17,16,1,0,1,2,"coding"
"NOV",15,10,5,0,1,2,"coding"
"NR0B2",6,4,2,0,1,2,"coding"
"NR1D2",40,38,2,0,1,2,"coding"
"NR1H3",65,10,55,0,1,2,"coding"
"NUDT21",52,42,10,0,1,2,"coding"
"PDPK1",80,68,12,0,1,2,"coding"
"PLEKHF2",40,38,2,0,1,2,"coding"
"PLK1",56,37,19,0,1,2,"coding"
"PPP1R8",16,13,3,0,1,2,"coding"
"PPP2CB",24,23,1,0,1,2,"coding"
"PSMA1",16,10,6,0,1,2,"coding"
"PTPN6",57,15,42,0,1,2,"coding"
"RAB1A",50,48,2,0,1,2,"coding"
"RAB3A",4,2,2,0,1,2,"coding"
"RAP1A",69,55,14,0,1,2,"coding"
"RASA1",64,45,19,0,1,2,"coding"
"RPL8",20,16,4,0,1,2,"coding"
"SIX5",119,35,84,0,1,2,"coding"
"SMAD5",65,56,9,0,1,2,"coding"
"SNAP23",41,35,6,0,1,2,"coding"
"SNRPD2",20,12,8,0,1,2,"coding"
"STC2",64,62,2,0,1,2,"coding"
"STK11",40,35,5,0,1,2,"coding"
"SYT1",29,25,4,0,1,2,"coding"
"TAF9",19,13,6,0,1,2,"coding"
"TGFB1",26,14,12,0,1,2,"coding"
"TICAM2",12,7,5,0,1,2,"coding"
"TNIP2",31,29,2,0,1,2,"coding"
"TRAF1",58,46,12,0,1,2,"coding"
"TUBB3",8,5,3,0,1,2,"coding"
"UBQLN1",52,45,7,0,1,2,"coding"
"VIM",78,62,16,0,1,2,"coding"
"VIPR1",9,8,1,0,1,2,"coding"
"YES1",55,49,6,0,1,2,"coding"
"YWHAB",108,86,22,0,1,2,"coding"
"ADM",40,38,2,0,1,1,"coding"
"AKAP10",33,28,5,0,1,1,"coding"
"ARHGDIA",77,75,2,0,1,1,"coding"
"ARRB1",40,30,10,0,1,1,"coding"
"ASGR1",17,15,2,0,1,1,"coding"
"ATXN1L",80,71,9,0,1,1,"coding"
"BAD",24,14,10,0,1,1,"coding"
"BCL2A1",6,4,2,0,1,1,"coding"
"BCL2L1",42,37,5,0,1,1,"coding"
"BLNK",18,13,5,0,1,1,"coding"
"C8orf33",43,39,4,0,1,1,"coding"
"CASP3",102,67,35,0,1,1,"coding"
"CCDC90B",15,13,2,0,1,1,"coding"
"CCL19",7,4,3,0,1,1,"coding"
"CCR5",43,35,8,0,1,1,"coding"
"CDC20",19,15,4,0,1,1,"coding"
"CDC25A",81,78,3,0,1,1,"coding"
"CDC34",27,25,2,0,1,1,"coding"
"CDK2AP2",11,9,2,0,1,1,"coding"
"CDK4",74,60,14,0,1,1,"coding"
"CDKN1A",83,74,9,0,1,1,"coding"
"CFL1",23,19,4,0,1,1,"coding"
"CHFR",13,10,3,0,1,1,"coding"
"CRK",142,119,23,0,1,1,"coding"
"CRKL",138,121,17,0,1,1,"coding"
"CSNK2A2",21,17,4,0,1,1,"coding"
"CTSD",12,9,3,0,1,1,"coding"
"CTSG",12,8,4,0,1,1,"coding"
"DIABLO",28,25,3,0,1,1,"coding"
"DLG4",34,16,18,0,1,1,"coding"
"DPPA2",2,1,1,0,1,1,"coding"
"DVL3",35,33,2,0,1,1,"coding"
"ECH1",11,9,2,0,1,1,"coding"
"EDN3",7,6,1,0,1,1,"coding"
"EEF1G",35,16,19,0,1,1,"coding"
"EFNA5",49,48,1,0,1,1,"coding"
"EXOSC10",24,19,5,0,1,1,"coding"
"EXOSC4",16,7,9,0,1,1,"coding"
"EZR",25,20,5,0,1,1,"coding"
"FHL3",16,15,1,0,1,1,"coding"
"FRS2",93,87,6,0,1,1,"coding"
"GAPDH",56,39,17,0,1,1,"coding"
"GATA2",262,20,242,0,1,1,"coding"
"GIPC1",27,19,8,0,1,1,"coding"
"GNA13",69,56,13,0,1,1,"coding"
"GNAQ",50,37,13,0,1,1,"coding"
"GNB2",31,26,5,0,1,1,"coding"
"GOLM1",26,25,1,0,1,1,"coding"
"GOT2",16,12,4,0,1,1,"coding"
"HCK",39,28,11,0,1,1,"coding"
"HDAC3",16,14,2,0,1,1,"coding"
"HMOX2",24,16,8,0,1,1,"coding"
"ID3",36,32,4,0,1,1,"coding"
"ITGA3",32,29,3,0,1,1,"coding"
"KLRD1",28,27,1,0,1,1,"coding"
"KPNA1",83,81,2,0,1,1,"coding"
"KRT15",18,14,4,0,1,1,"coding"
"LAT",22,11,11,0,1,1,"coding"
"LDB1",41,39,2,0,1,1,"coding"
"LIMS1",54,50,4,0,1,1,"coding"
"LRPAP1",35,32,3,0,1,1,"coding"
"LSM4",20,15,5,0,1,1,"coding"
"MAP2K6",35,34,1,0,1,1,"coding"
"MAPK1",195,167,28,0,1,1,"coding"
"MAPK13",14,13,1,0,1,1,"coding"
"MCL1",86,84,2,0,1,1,"coding"
"MPP6",43,41,2,0,1,1,"coding"
"MYD88",28,21,7,0,1,1,"coding"
"NAIP",4,3,1,0,1,1,"coding"
"NDN",20,16,4,0,1,1,"coding"
"NR5A1",7,5,2,0,1,1,"coding"
"NUDT18",20,14,6,0,1,1,"coding"
"PARD6A",12,6,6,0,1,1,"coding"
"PEBP1",49,47,2,0,1,1,"coding"
"PEX5",17,14,3,0,1,1,"coding"
"PFDN1",21,15,6,0,1,1,"coding"
"POLR3F",27,24,3,0,1,1,"coding"
"PPP2R5A",22,19,3,0,1,1,"coding"
"PRKCI",29,23,6,0,1,1,"coding"
"PTGFR",17,15,2,0,1,1,"coding"
"PTN",18,8,10,0,1,1,"coding"
"PTPN11",88,55,33,0,1,1,"coding"
"RAB27A",39,31,8,0,1,1,"coding"
"RAN",70,62,8,0,1,1,"coding"
"RAP2A",32,27,5,0,1,1,"coding"
"RBBP4",65,57,8,0,1,1,"coding"
"RPP14",57,55,2,0,1,1,"coding"
"RPS10",17,15,2,0,1,1,"coding"
"RYBP",95,92,3,0,1,1,"coding"
"S100A6",4,3,1,0,1,1,"coding"
"S1PR1",43,40,3,0,1,1,"coding"
"SKI",117,111,6,0,1,1,"coding"
"SKP1",31,28,3,0,1,1,"coding"
"SMAD1",207,29,178,0,1,1,"coding"
"SMAD7",62,57,5,0,1,1,"coding"
"SNCA",30,13,17,0,1,1,"coding"
"SNRNP70",23,20,3,0,1,1,"coding"
"SRC",72,40,32,0,1,1,"coding"
"SRF",252,31,221,0,1,1,"coding"
"STX8",6,5,1,0,1,1,"coding"
"TK1",92,68,24,0,1,1,"coding"
"TNK2",26,25,1,0,1,1,"coding"
"TOM1L1",14,6,8,0,1,1,"coding"
"TRAF2",91,21,70,0,1,1,"coding"
"TRIM5",23,21,2,0,1,1,"coding"
"TUBA4A",17,12,5,0,1,1,"coding"
"UBE2I",74,62,12,0,1,1,"coding"
"UNC119",40,22,18,0,1,1,"coding"
"VAMP2",29,25,4,0,1,1,"coding"
"VDAC1",31,26,5,0,1,1,"coding"
"WNT4",28,27,1,0,1,1,"coding"
"YAP1",80,77,3,0,1,1,"coding"
"YWHAG",214,174,40,0,1,1,"coding"
"ZNF446",18,17,1,0,1,1,"coding"
"ZNF512B",74,65,9,0,1,1,"coding"
"ACP1",24,23,1,0,1,NA,"coding"
"ACVR1",63,44,19,0,1,NA,"coding"
"ADAM17",45,39,6,0,1,NA,"coding"
"APOE",11,3,8,0,1,NA,"coding"
"ARHGAP8",4,3,1,0,1,NA,"coding"
"ARL4D",28,27,1,0,1,NA,"coding"
"ARPC3",17,16,1,0,1,NA,"coding"
"ATP5J2",9,7,2,0,1,NA,"coding"
"BCL2",72,69,3,0,1,NA,"coding"
"C14orf1",24,20,4,0,1,NA,"coding"
"CACYBP",14,13,1,0,1,NA,"coding"
"CALM1",71,63,8,0,1,NA,"coding"
"CAPNS1",27,23,4,0,1,NA,"coding"
"CCDC85B",74,61,13,0,1,NA,"coding"
"CD247",21,7,14,0,1,NA,"coding"
"CD79A",12,7,5,0,1,NA,"coding"
"CDC42",69,46,23,0,1,NA,"coding"
"CDK9",45,35,10,0,1,NA,"coding"
"CEBPG",34,31,3,0,1,NA,"coding"
"CHMP1B",31,29,2,0,1,NA,"coding"
"CIB1",11,7,4,0,1,NA,"coding"
"CLTA",25,24,1,0,1,NA,"coding"
"CSK",30,22,8,0,1,NA,"coding"
"CSNK2B",53,21,32,0,1,NA,"coding"
"CXCL13",7,6,1,0,1,NA,"coding"
"CYCS",65,63,2,0,1,NA,"coding"
"DAZAP2",90,86,4,0,1,NA,"coding"
"DHFR",9,8,1,0,1,NA,"coding"
"DUSP23",12,7,5,0,1,NA,"coding"
"DVL2",29,20,9,0,1,NA,"coding"
"DYNLL1",34,26,8,0,1,NA,"coding"
"DYNLL2",76,73,3,0,1,NA,"coding"
"EBI3",14,13,1,0,1,NA,"coding"
"EIF4E",61,59,2,0,1,NA,"coding"
"EIF4EBP1",48,44,4,0,1,NA,"coding"
"FCER1G",10,5,5,0,1,NA,"coding"
"FKBP1A",49,48,1,0,1,NA,"coding"
"FOXA2",203,6,197,0,1,NA,"coding"
"FYN",124,80,44,0,1,NA,"coding"
"FZR1",22,18,4,0,1,NA,"coding"
"GABARAPL2",10,9,1,0,1,NA,"coding"
"GADD45G",24,13,11,0,1,NA,"coding"
"GATA6",154,96,58,0,1,NA,"coding"
"GNA15",2,1,1,0,1,NA,"coding"
"GNG13",6,5,1,0,1,NA,"coding"
"GRB2",84,52,32,0,1,NA,"coding"
"H2AFX",46,39,7,0,1,NA,"coding"
"HCST",3,2,1,0,1,NA,"coding"
"HSPA1A",49,37,12,0,1,NA,"coding"
"HSPA1B",45,44,1,0,1,NA,"coding"
"IGF1",81,80,1,0,1,NA,"coding"
"IL2",10,8,2,0,1,NA,"coding"
"LSM2",8,3,5,0,1,NA,"coding"
"LTB",11,9,2,0,1,NA,"coding"
"MAFG",38,36,2,0,1,NA,"coding"
"MAP1LC3B",33,29,4,0,1,NA,"coding"
"MAPK11",9,8,1,0,1,NA,"coding"
"MAPK12",12,6,6,0,1,NA,"coding"
"MDFI",33,29,4,0,1,NA,"coding"
"MED31",27,23,4,0,1,NA,"coding"
"MED9",11,9,2,0,1,NA,"coding"
"MRPL44",13,12,1,0,1,NA,"coding"
"MVD",5,4,1,0,1,NA,"coding"
"NFYA",174,41,133,0,1,NA,"coding"
"NME1",23,18,5,0,1,NA,"coding"
"NPM1",39,35,4,0,1,NA,"coding"
"PAFAH1B2",90,88,2,0,1,NA,"coding"
"PCNA",65,58,7,0,1,NA,"coding"
"PFN1",48,41,7,0,1,NA,"coding"
"PFN2",69,64,5,0,1,NA,"coding"
"PIN1",62,45,17,0,1,NA,"coding"
"PLSCR1",52,36,16,0,1,NA,"coding"
"POMC",8,7,1,0,1,NA,"coding"
"PPP1CA",39,32,7,0,1,NA,"coding"
"PPP1CC",63,60,3,0,1,NA,"coding"
"PRMT1",32,20,12,0,1,NA,"coding"
"PRSS23",24,21,3,0,1,NA,"coding"
"RAC1",77,61,16,0,1,NA,"coding"
"RAP1GAP",9,8,1,0,1,NA,"coding"
"RASSF1",18,13,5,0,1,NA,"coding"
"RBL2",39,33,6,0,1,NA,"coding"
"RBPMS",30,28,2,0,1,NA,"coding"
"RGS19",26,19,7,0,1,NA,"coding"
"RGS2",20,10,10,0,1,NA,"coding"
"RHOD",6,2,4,0,1,NA,"coding"
"RHOG",22,19,3,0,1,NA,"coding"
"RING1",15,12,3,0,1,NA,"coding"
"RIT1",26,24,2,0,1,NA,"coding"
"RNF11",121,103,18,0,1,NA,"coding"
"RNF4",44,43,1,0,1,NA,"coding"
"RNF7",16,14,2,0,1,NA,"coding"
"RPL13",14,10,4,0,1,NA,"coding"
"RPLP1",50,43,7,0,1,NA,"coding"
"S100A8",10,9,1,0,1,NA,"coding"
"SCT",2,1,1,0,1,NA,"coding"
"SDCBP",48,42,6,0,1,NA,"coding"
"SGTA",16,12,4,0,1,NA,"coding"
"SIVA1",12,10,2,0,1,NA,"coding"
"SLC9A3R2",33,25,8,0,1,NA,"coding"
"SMN1",39,15,24,0,1,NA,"coding"
"SNIP1",51,48,3,0,1,NA,"coding"
"SOCS1",55,45,10,0,1,NA,"coding"
"SOCS3",38,33,5,0,1,NA,"coding"
"SSSCA1",11,10,1,0,1,NA,"coding"
"SUMO2",42,38,4,0,1,NA,"coding"
"SUMO4",4,2,2,0,1,NA,"coding"
"TAF10",21,12,9,0,1,NA,"coding"
"TCAP",6,3,3,0,1,NA,"coding"
"TCEB2",17,11,6,0,1,NA,"coding"
"TNFRSF14",15,10,5,0,1,NA,"coding"
"TNFSF11",28,19,9,0,1,NA,"coding"
"TNFSF12",4,3,1,0,1,NA,"coding"
"TSC22D4",20,16,4,0,1,NA,"coding"
"TUBB2A",98,95,3,0,1,NA,"coding"
"TYROBP",6,4,2,0,1,NA,"coding"
"UBE2E2",19,18,1,0,1,NA,"coding"
"VHL",48,42,6,0,1,NA,"coding"
"WNT1",19,18,1,0,1,NA,"coding"
"YWHAE",98,85,13,0,1,NA,"coding"
"YWHAH",45,43,2,0,1,NA,"coding"
"YWHAQ",84,72,12,0,1,NA,"coding"
