"Name","K","Kin","Kout","TypeI","TypeII"
"ANXA7",38,25,13,0,1
"TK1",45,25,20,0,1
"A2M",10,5,5,0,1
"MYOC",7,3,4,0,1
"NUDT21",21,11,10,0,1
"RAP1B",17,15,2,0,1
"MAP1LC3B",20,16,4,0,1
"MDFI",18,16,2,0,1
"RB1",79,65,14,0,1
"ABCA1",26,21,5,0,1
"CSNK2A1",48,32,16,0,1
"HAX1",11,8,3,0,1
"RDX",12,8,4,0,1
"STX1A",11,5,6,0,1
"ABCF3",3,2,1,0,1
"HSPA8",18,9,9,0,1
"SOS1",33,22,11,0,1
"SOS2",15,11,4,0,1
"ABL1",33,15,18,0,1
"CAV1",50,33,17,0,1
"CRK",49,23,26,0,1
"POLR2A",33,25,8,0,1
"PRKD1",19,16,3,0,1
"RAN",37,29,8,0,1
"XRCC6",10,5,5,0,1
"ABL2",8,5,3,0,1
"CALCOCO2",17,13,4,0,1
"VIM",43,29,14,0,1
"YWHAG",117,88,29,0,1
"ATXN1",70,49,21,0,1
"USP7",24,21,3,0,1
"CFL1",11,7,4,0,1
"GSN",10,6,4,0,1
"PFN1",16,10,6,0,1
"VCL",54,30,24,0,1
"ACTB",26,14,12,0,1
"CDKN1A",46,40,6,0,1
"EMD",11,7,4,0,1
"H2AFX",11,7,4,0,1
"PFDN1",11,7,4,0,1
"ACTN4",9,5,4,0,1
"ACTG1",12,4,8,0,1
"ATF7IP",40,23,17,0,1
"DYNLL1",29,20,9,0,1
"PFN2",14,12,2,0,1
"RPS6KA5",18,13,5,0,1
"ST3GAL3",4,3,1,0,1
"ACTN1",24,18,6,0,1
"CDK5",16,12,4,0,1
"PKN1",13,11,2,0,1
"COIL",35,28,7,0,1
"MAGI1",12,5,7,0,1
"ACTR2",14,8,6,0,1
"CDC42",49,26,23,0,1
"CDH1",21,10,11,0,1
"ACVR1",35,22,13,0,1
"IKBKB",11,9,2,0,1
"ACVR1B",6,4,2,0,1
"TDGF1",5,3,2,0,1
"MAGI2",10,7,3,0,1
"TGFB1",27,15,12,0,1
"TGFB3",10,7,3,0,1
"TGFBR2",58,48,10,0,1
"XIAP",28,18,10,0,1
"ADAM10",9,7,2,0,1
"MAD2L1",10,5,5,0,1
"TNFSF11",10,7,3,0,1
"FN1",60,42,18,0,1
"PRKCA",57,24,33,0,1
"CALM1",10,6,4,0,1
"PRKCD",21,15,6,0,1
"APPL1",16,11,5,0,1
"ADORA1",4,3,1,0,1
"GNAZ",5,3,2,0,1
"FLNC",22,15,7,0,1
"GNAI2",40,34,6,0,1
"YWHAZ",53,21,32,0,1
"ARRB1",23,13,10,0,1
"ADRB2",17,8,9,0,1
"CSK",17,13,4,0,1
"GNA11",11,7,4,0,1
"GPRASP1",19,8,11,0,1
"GRB2",73,44,29,0,1
"GRK5",17,8,9,0,1
"ADRBK1",14,6,8,0,1
"GIT1",19,12,7,0,1
"PRKCB",34,23,11,0,1
"CXCR4",13,7,6,0,1
"PRKCE",15,7,8,0,1
"ATXN1L",31,21,10,0,1
"AFF1",24,21,3,0,1
"UBE3A",26,23,3,0,1
"CCDC85B",60,49,11,0,1
"AGTR1",8,3,5,0,1
"JAK2",54,24,30,0,1
"NOS3",5,4,1,0,1
"AHR",27,14,13,0,1
"ARNT",16,8,8,0,1
"EP300",128,109,19,0,1
"NCOA1",39,22,17,0,1
"NCOA2",24,13,11,0,1
"SETDB1",46,40,6,0,1
"PRKAR2A",24,18,6,0,1
"AKAP10",11,6,5,0,1
"P4HB",7,3,4,0,1
"PRKAR1A",24,11,13,0,1
"GSK3B",63,33,30,0,1
"YWHAB",45,30,15,0,1
"YWHAE",35,24,11,0,1
"KPNB1",45,32,13,0,1
"PRPF40A",49,32,17,0,1
"AKAP9",20,16,4,0,1
"AKT1",19,5,14,0,1
"CHUK",32,17,15,0,1
"MDM2",31,24,7,0,1
"PRKDC",28,20,8,0,1
"RAF1",19,11,8,0,1
"TCEA2",9,7,2,0,1
"PDPK1",39,29,10,0,1
"UNC119",23,11,12,0,1
"XRN1",17,13,4,0,1
"CLTC",30,18,12,0,1
"TEK",10,4,6,0,1
"ANK2",9,7,2,0,1
"HDAC4",19,17,2,0,1
"PIP4K2C",7,3,4,0,1
"LRP2",11,6,5,0,1
"TGM2",14,9,5,0,1
"S100A6",4,3,1,0,1
"RBBP4",19,15,4,0,1
"AP2B1",16,8,8,0,1
"AP2A1",12,7,5,0,1
"BIN1",9,5,4,0,1
"HIP1",12,9,3,0,1
"ARF1",11,7,4,0,1
"CSNK1A1",22,17,5,0,1
"CASP3",53,18,35,0,1
"APP",20,11,9,0,1
"MAPK6",62,33,29,0,1
"APBB1",5,4,1,0,1
"APLP1",8,7,1,0,1
"CTBP1",21,17,4,0,1
"SIAH1",15,12,3,0,1
"TRIM37",18,14,4,0,1
"APOA1",5,2,3,0,1
"TP53BP2",24,19,5,0,1
"APPBP2",4,3,1,0,1
"PIK3CA",16,8,8,0,1
"APTX",6,5,1,0,1
"EFEMP2",15,9,6,0,1
"AR",144,32,112,0,1
"CDC37",24,19,5,0,1
"CREBBP",101,45,56,0,1
"FOXA1",60,10,50,0,1
"KAT2B",38,32,6,0,1
"NCOA3",36,25,11,0,1
"NCOR1",40,22,18,0,1
"POU5F1",9,3,6,0,1
"RNF4",8,7,1,0,1
"SMAD1",39,13,26,0,1
"SMAD3",80,33,47,0,1
"SP1",95,37,58,0,1
"TCF4",63,29,34,0,1
"SMN1",8,2,6,0,1
"ITPR1",28,19,9,0,1
"PIK3R1",79,41,38,0,1
"RASA1",39,18,21,0,1
"SMURF2",27,14,13,0,1
"ARHGDIA",17,15,2,0,1
"RAC2",6,4,2,0,1
"VAV1",34,26,8,0,1
"ARHGEF12",22,16,6,0,1
"CD44",12,4,8,0,1
"GNA12",14,5,9,0,1
"IGF1R",24,12,12,0,1
"RHOA",15,8,7,0,1
"TGFBR1",73,32,41,0,1
"ARHGEF7",10,5,5,0,1
"CBLB",19,12,7,0,1
"SIN3A",33,29,4,0,1
"GAPDH",36,18,18,0,1
"UBR1",22,11,11,0,1
"ARL4D",10,8,2,0,1
"NUDT3",19,13,6,0,1
"WAS",21,11,10,0,1
"ARR3",2,1,1,0,1
"CAPNS1",4,1,3,0,1
"HCK",36,28,8,0,1
"ARRB2",12,7,5,0,1
"HIPK3",21,18,3,0,1
"ASF1A",16,15,1,0,1
"ASGR1",9,6,3,0,1
"CREB1",45,17,28,0,1
"GABPA",22,6,16,0,1
"GABPB1",16,11,5,0,1
"JUN",77,24,53,0,1
"CEBPG",19,17,2,0,1
"DDIT3",5,3,2,0,1
"CDC34",12,11,1,0,1
"GTF2H1",10,7,3,0,1
"LUC7L2",24,19,5,0,1
"EIF4EBP1",11,9,2,0,1
"RAD51",24,20,4,0,1
"TOPBP1",15,13,2,0,1
"WRN",8,7,1,0,1
"ATN1",17,10,7,0,1
"EWSR1",16,7,9,0,1
"TRIP6",19,13,6,0,1
"BCL2",44,33,11,0,1
"ATP2B4",7,6,1,0,1
"SRC",17,7,10,0,1
"PIN1",36,24,12,0,1
"RPP14",6,5,1,0,1
"ATP5C1",11,9,2,0,1
"PJA1",4,3,1,0,1
"ATP5J2",6,4,2,0,1
"ATR",9,3,6,0,1
"DAZAP2",27,22,5,0,1
"RAD23B",11,10,1,0,1
"RNF11",43,28,15,0,1
"AURKA",18,13,5,0,1
"NME1",11,7,4,0,1
"PPP1CA",17,11,6,0,1
"PPP1CC",19,16,3,0,1
"AXIN1",18,5,13,0,1
"CTNNB1",58,38,20,0,1
"JUP",16,13,3,0,1
"PPP2CA",16,8,8,0,1
"SH3GL1",14,8,6,0,1
"AXL",24,11,13,0,1
"CBL",59,34,25,0,1
"IL2RG",12,9,3,0,1
"LCK",60,33,27,0,1
"PIK3R2",13,7,6,0,1
"PTPN11",61,24,37,0,1
"SHC1",46,28,18,0,1
"SOCS1",25,16,9,0,1
"B2M",14,11,3,0,1
"HLA-A",10,8,2,0,1
"RANBP9",9,5,4,0,1
"BACH1",14,12,2,0,1
"MAPK8",39,32,7,0,1
"SFN",9,8,1,0,1
"YWHAQ",44,33,11,0,1
"HSPA1A",12,10,2,0,1
"BAG4",11,9,2,0,1
"BAHD1",5,4,1,0,1
"KRTAP4-12",3,1,2,0,1
"DLG4",42,20,22,0,1
"BRD7",16,13,3,0,1
"IKBKAP",12,8,4,0,1
"MAP3K7",26,19,7,0,1
"BCAR1",21,14,7,0,1
"MAPK1",71,52,19,0,1
"BCL2A1",4,3,1,0,1
"NCOR2",22,11,11,0,1
"RUNX1T1",73,42,31,0,1
"GRK6",8,5,3,0,1
"NEK9",19,18,1,0,1
"CSNK2B",48,16,32,0,1
"DIABLO",11,8,3,0,1
"IKBKG",25,20,5,0,1
"TRAF1",34,22,12,0,1
"UBB",17,7,10,0,1
"CASP7",18,14,4,0,1
"BLK",6,4,2,0,1
"SUMO2",24,19,5,0,1
"BLNK",16,13,3,0,1
"BMI1",11,7,4,0,1
"RING1",10,7,3,0,1
"HSPG2",26,21,5,0,1
"BMPR2",33,24,9,0,1
"RAP2A",12,9,3,0,1
"STUB1",12,2,10,0,1
"ROBO2",12,8,4,0,1
"MAP2K1",12,6,6,0,1
"BRCA2",13,8,5,0,1
"CCNA2",35,32,3,0,1
"CDK2",49,43,6,0,1
"KPNA1",13,10,3,0,1
"NFYA",35,12,23,0,1
"BRF1",10,5,5,0,1
"BRMS1",6,2,4,0,1
"PDLIM7",9,6,3,0,1
"TRIM5",3,2,1,0,1
"BTK",40,8,32,0,1
"FAS",22,10,12,0,1
"LYN",57,30,27,0,1
"MYD88",15,10,5,0,1
"PLCG2",33,24,9,0,1
"PRKCQ",13,5,8,0,1
"SYK",44,15,29,0,1
"SKP1",7,5,2,0,1
"YAP1",17,14,3,0,1
"BUB1",14,8,6,0,1
"PLK1",36,19,17,0,1
"BUB1B",8,6,2,0,1
"C11orf58",8,4,4,0,1
"KIAA1377",34,14,20,0,1
"SF3B1",12,7,5,0,1
"C14orf1",12,8,4,0,1
"KRT15",12,9,3,0,1
"DCN",20,13,7,0,1
"UBQLN4",45,21,24,0,1
"C3",14,6,8,0,1
"C4A",4,1,3,0,1
"FGFR3",4,2,2,0,1
"C8orf33",11,7,4,0,1
"CABP2",3,2,1,0,1
"SIAH2",3,2,1,0,1
"CADPS2",3,2,1,0,1
"DMD",5,4,1,0,1
"TUBA4A",10,5,5,0,1
"GPRASP2",10,4,6,0,1
"STRN4",10,5,5,0,1
"THBS1",48,38,10,0,1
"TRAF6",32,12,20,0,1
"CAMK2A",13,9,4,0,1
"CPSF6",19,16,3,0,1
"CANX",9,5,4,0,1
"SPTAN1",16,7,9,0,1
"EPB41",25,12,13,0,1
"PRKD2",7,4,3,0,1
"HTT",30,19,11,0,1
"DSP",14,12,2,0,1
"KPNA2",30,28,2,0,1
"EIF2AK2",28,17,11,0,1
"NEDD4",26,24,2,0,1
"TOP1",10,8,2,0,1
"CLSPN",3,2,1,0,1
"RIPK1",12,8,4,0,1
"RNF19A",10,6,4,0,1
"SUMO4",3,1,2,0,1
"ILK",18,13,5,0,1
"PTPRF",26,21,5,0,1
"EGFR",50,18,32,0,1
"CD5",13,10,3,0,1
"INSR",40,20,20,0,1
"ITCH",7,4,3,0,1
"SPRY2",11,10,1,0,1
"CRY1",5,2,3,0,1
"TRIM24",18,12,6,0,1
"COPS6",35,21,14,0,1
"MCM10",21,13,8,0,1
"CCR5",28,17,11,0,1
"CXCL13",5,4,1,0,1
"VCAN",29,20,9,0,1
"CCL21",5,3,2,0,1
"DPP4",8,3,5,0,1
"CCL3",6,5,1,0,1
"CCR3",12,5,7,0,1
"PIGR",4,3,1,0,1
"FEZ1",11,4,7,0,1
"CDC25A",31,29,2,0,1
"PTMA",20,6,14,0,1
"HDAC3",9,6,3,0,1
"SKP2",25,18,7,0,1
"CDK7",7,5,2,0,1
"DVL3",9,7,2,0,1
"CDK9",17,10,7,0,1
"JAK1",49,27,22,0,1
"CD4",28,14,14,0,1
"DNM2",8,4,4,0,1
"PTK2B",31,15,16,0,1
"MED31",10,7,3,0,1
"RCC1",20,17,3,0,1
"ITGB2",25,11,14,0,1
"ITGA3",12,9,3,0,1
"ITGA6",12,6,6,0,1
"ITGB1",52,27,25,0,1
"CD79A",10,5,5,0,1
"FYN",88,47,41,0,1
"PTPRC",33,17,16,0,1
"LAT",20,9,11,0,1
"CD247",20,5,15,0,1
"JAK3",19,9,10,0,1
"TRAF2",64,11,53,0,1
"TRAF3",17,11,6,0,1
"GRAP2",24,14,10,0,1
"CD3E",12,9,3,0,1
"CTSD",7,3,4,0,1
"IL16",14,9,5,0,1
"CD40",12,3,9,0,1
"PTK2",30,11,19,0,1
"UBQLN1",19,11,8,0,1
"CD8A",12,5,7,0,1
"COL4A1",26,20,6,0,1
"SAFB",11,6,5,0,1
"ITSN1",29,22,7,0,1
"KTN1",10,8,2,0,1
"PRKCI",17,12,5,0,1
"TNK2",10,9,1,0,1
"CTNND1",15,12,3,0,1
"CDH2",10,6,4,0,1
"CDH5",11,7,4,0,1
"CTNNA1",9,6,3,0,1
"CDK5RAP1",3,1,2,0,1
"CDKN1B",13,5,8,0,1
"CEBPA",9,2,7,0,1
"GATA2",79,17,62,0,1
"SMARCC1",11,7,4,0,1
"SPTBN2",8,6,2,0,1
"NEK2",7,5,2,0,1
"CEP76",7,4,3,0,1
"CGN",4,2,2,0,1
"CHEK2",17,8,9,0,1
"ICAM3",5,3,2,0,1
"TYROBP",8,6,2,0,1
"EPB41L3",14,11,3,0,1
"HGS",22,10,12,0,1
"RABAC1",25,16,9,0,1
"CNKSR1",3,2,1,0,1
"GNAI1",5,4,1,0,1
"MET",9,3,6,0,1
"IL6ST",34,28,6,0,1
"LIFR",5,3,2,0,1
"PTPRB",16,13,3,0,1
"CNTNAP2",3,2,1,0,1
"COL17A1",5,2,3,0,1
"FBLN2",13,9,4,0,1
"SNCA",18,8,10,0,1
"COL2A1",5,3,2,0,1
"PXN",21,10,11,0,1
"XRN2",8,6,2,0,1
"MAPK14",30,22,8,0,1
"COPS3",13,9,4,0,1
"CPE",23,19,4,0,1
"POLA2",12,7,5,0,1
"RPA1",14,3,11,0,1
"E2F1",57,15,42,0,1
"EBF1",62,21,41,0,1
"MAFG",7,4,3,0,1
"NFATC2",14,5,9,0,1
"PROX1",13,10,3,0,1
"SNIP1",27,22,5,0,1
"TCF12",31,9,22,0,1
"HAP1",11,8,3,0,1
"GAB1",22,15,7,0,1
"CRMP1",19,7,12,0,1
"CSF1",8,5,3,0,1
"INPP5D",16,7,9,0,1
"CSF2RB",18,7,11,0,1
"FES",14,9,5,0,1
"IL3",4,2,2,0,1
"KDR",29,12,17,0,1
"HNRNPK",19,11,8,0,1
"GTF2A1",13,9,4,0,1
"PPP1R8",10,4,6,0,1
"CTBP2",5,3,2,0,1
"CTCF",30,8,22,0,1
"CTGF",16,14,2,0,1
"NOV",4,3,1,0,1
"RUVBL1",7,6,1,0,1
"ZFYVE9",17,11,6,0,1
"CTR9",5,3,2,0,1
"LRP1",37,26,11,0,1
"CTSS",5,4,1,0,1
"CTTN",5,3,2,0,1
"NCF4",7,6,1,0,1
"CYCS",11,10,1,0,1
"PML",10,8,2,0,1
"UBE2I",20,14,6,0,1
"MCM7",25,17,8,0,1
"FLNA",23,16,7,0,1
"TRIM39",2,1,1,0,1
"DFNB31",2,1,1,0,1
"ILF3",20,19,1,0,1
"PSMA1",7,4,3,0,1
"MAPK12",13,6,7,0,1
"DLST",6,4,2,0,1
"DNMBP",7,5,2,0,1
"TRIM27",3,2,1,0,1
"PPP2CB",7,5,2,0,1
"DOK1",20,8,12,0,1
"EPB41L2",6,1,5,0,1
"NCK1",31,6,25,0,1
"NOTCH1",7,4,3,0,1
"DUSP23",11,6,5,0,1
"EED",15,13,2,0,1
"PRPF3",5,2,3,0,1
"PNN",9,4,5,0,1
"E2F6",54,9,45,0,1
"E2F2",21,13,8,0,1
"TFDP1",12,9,3,0,1
"E2F3",59,30,29,0,1
"EEF1A1",20,8,12,0,1
"GADD45G",18,9,9,0,1
"EEF1D",14,10,4,0,1
"EFNA3",5,4,1,0,1
"PRSS23",18,16,2,0,1
"EFNB2",12,7,5,0,1
"PTPN13",11,7,4,0,1
"SNRPD2",11,5,6,0,1
"EHMT2",10,9,1,0,1
"EIF3E",10,6,4,0,1
"EIF4E",10,8,2,0,1
"MVD",4,3,1,0,1
"SRF",20,6,14,0,1
"NMI",11,10,1,0,1
"SYNCRIP",36,35,1,0,1
"ERCC3",5,2,3,0,1
"ERCC5",5,2,3,0,1
"ERG",97,18,79,0,1
"FLI1",84,16,68,0,1
"IGSF21",8,4,4,0,1
"NR0B1",3,2,1,0,1
"PSMC5",12,10,2,0,1
"ETS2",10,8,2,0,1
"SF1",9,7,2,0,1
"UPF2",15,8,7,0,1
"EXOSC4",12,4,8,0,1
"PSMB1",5,2,3,0,1
"F2R",18,12,6,0,1
"ITGAV",22,13,9,0,1
"F2RL2",7,4,3,0,1
"FAM118B",3,2,1,0,1
"FAM46A",2,1,1,0,1
"RAP1A",19,7,12,0,1
"PRMT1",16,9,7,0,1
"FBLN1",11,7,4,0,1
"FCER1G",7,3,4,0,1
"FCGR1A",5,2,3,0,1
"ZAP70",25,2,23,0,1
"GNAO1",13,3,10,0,1
"RPS6KA3",12,5,7,0,1
"FIGF",4,2,2,0,1
"TRIM23",8,6,2,0,1
"GATA4",16,7,9,0,1
"MITF",27,15,12,0,1
"SMAD4",40,7,33,0,1
"SMAD2",50,17,33,0,1
"TAF10",13,6,7,0,1
"FURIN",8,3,5,0,1
"FXR2",16,11,5,0,1
"MAP3K3",19,17,2,0,1
"GABARAP",5,2,3,0,1
"GRASP",5,3,2,0,1
"SH3GL3",6,3,3,0,1
"PPP3CA",9,2,7,0,1
"RAB2A",4,2,2,0,1
"IARS",10,9,1,0,1
"GDF9",3,1,2,0,1
"S100A8",7,5,2,0,1
"GDI2",11,10,1,0,1
"NCAM1",13,10,3,0,1
"RET",13,5,8,0,1
"GGA1",9,3,6,0,1
"GGA2",16,8,8,0,1
"RGS19",12,6,6,0,1
"PTN",13,5,8,0,1
"HMOX2",8,3,5,0,1
"TWIST1",26,14,12,0,1
"HTR2A",12,5,7,0,1
"TRPC3",8,3,5,0,1
"GNA15",4,2,2,0,1
"OPRD1",5,2,3,0,1
"RGS1",5,3,2,0,1
"GNAQ",16,7,9,0,1
"GNAS",10,5,5,0,1
"PABPC1",23,17,6,0,1
"NUDT18",13,8,5,0,1
"GOLGA2",5,1,4,0,1
"GOLGA4",10,8,2,0,1
"IGF2",25,21,4,0,1
"LRSAM1",5,4,1,0,1
"GRIN2D",2,1,1,0,1
"PPP2R2A",3,1,2,0,1
"GRN",6,4,2,0,1
"GTF2B",10,8,2,0,1
"LMNB1",21,13,8,0,1
"HAND2",4,1,3,0,1
"MMP2",38,21,17,0,1
"HDAC6",6,3,3,0,1
"HEXDC",3,1,2,0,1
"HHIP",3,2,1,0,1
"HIPK2",20,17,3,0,1
"HK3",2,1,1,0,1
"HLA-B",8,5,3,0,1
"HLA-C",12,5,7,0,1
"LILRB2",11,5,6,0,1
"HMGCR",10,9,1,0,1
"NR1H2",17,2,15,0,1
"HNRNPA1",11,6,5,0,1
"PBX1",19,8,11,0,1
"MEIS1",10,6,4,0,1
"HRAS",31,15,16,0,1
"PRKCZ",13,8,5,0,1
"POLR2E",9,5,4,0,1
"HSPBP1",3,2,1,0,1
"KRT18",10,5,5,0,1
"VDAC1",4,2,2,0,1
"HSPB1",7,4,3,0,1
"MPDZ",6,2,4,0,1
"HTRA1",13,7,6,0,1
"ICAM1",9,7,2,0,1
"ITGA4",14,10,4,0,1
"ID1",11,8,3,0,1
"ELK4",17,15,2,0,1
"MYF5",9,5,4,0,1
"ID2",5,3,2,0,1
"ID3",12,9,3,0,1
"IFNAR1",13,6,7,0,1
"IFNAR2",6,2,4,0,1
"PIK3R3",17,14,3,0,1
"IGFBP5",34,28,6,0,1
"PLAU",11,8,3,0,1
"IGFBP4",20,17,3,0,1
"RANBP10",4,3,1,0,1
"IL4R",16,7,9,0,1
"TICAM2",8,4,4,0,1
"NGFR",16,10,6,0,1
"IL21",2,1,1,0,1
"PTPN6",44,8,36,0,1
"PIK3CD",6,4,2,0,1
"IRAK1",15,5,10,0,1
"IRF3",6,3,3,0,1
"ITGB7",9,3,6,0,1
"LTB",6,4,2,0,1
"ITGB8",12,11,1,0,1
"PRKG1",26,17,9,0,1
"SNAP25",13,12,1,0,1
"TJP1",12,7,5,0,1
"RIBC2",5,2,3,0,1
"WDYHV1",10,4,6,0,1
"KCNA2",5,3,2,0,1
"KHSRP",23,19,4,0,1
"KLF4",8,5,3,0,1
"NUP62",12,10,2,0,1
"KRT5",4,1,3,0,1
"PEA15",5,4,1,0,1
"LEF1",12,6,6,0,1
"LEPR",13,3,10,0,1
"LMO4",16,15,1,0,1
"LRPAP1",11,8,3,0,1
"RTN4",7,3,4,0,1
"LSM3",10,5,5,0,1
"LSM5",9,6,3,0,1
"TRAF4",8,5,3,0,1
"PTCD3",12,11,1,0,1
"WIPF1",15,12,3,0,1
"MED12",4,2,2,0,1
"PAFAH1B1",10,4,6,0,1
"MAP3K2",16,14,2,0,1
"MAP2K7",13,10,3,0,1
"MAP3K5",14,8,6,0,1
"PPP2R1A",5,4,1,0,1
"TTF2",19,11,8,0,1
"SMAD7",15,8,7,0,1
"ZNF512B",11,4,7,0,1
"PMCH",4,1,3,0,1
"UBE2A",4,1,3,0,1
"MEF2A",11,7,4,0,1
"PAX3",5,3,2,0,1
"RIT1",7,5,2,0,1
"TUBB3",4,1,3,0,1
"POU2F1",39,31,8,0,1
"MTA1",11,7,4,0,1
"SYNE1",19,15,4,0,1
"RAB11A",9,8,1,0,1
"SPRED1",12,10,2,0,1
"NCF2",4,1,3,0,1
"WASL",17,10,7,0,1
"NEDD8",5,2,3,0,1
"NEUROD1",3,2,1,0,1
"PDX1",2,1,1,0,1
"TARBP2",10,8,2,0,1
"VTA1",14,11,3,0,1
"SFPQ",44,23,21,0,1
"TUBB2A",8,7,1,0,1
"NR5A1",2,1,1,0,1
"RXRB",11,7,4,0,1
"POU2F2",30,8,22,0,1
"SYT4",4,2,2,0,1
"NTRK1",15,2,13,0,1
"NUP98",11,5,6,0,1
"RANBP2",27,16,11,0,1
"OPRM1",2,1,1,0,1
"OSGEP",6,1,5,0,1
"SLC9A3R2",12,9,3,0,1
"PARK2",7,2,5,0,1
"BACH2",13,12,1,0,1
"PBX2",9,4,5,0,1
"RAD50",7,4,3,0,1
"TSG101",5,3,2,0,1
"RAB8A",7,5,2,0,1
"RAD23A",9,4,5,0,1
"PDGFRB",32,13,19,0,1
"PDZK1",6,1,5,0,1
"PHYHIP",11,9,2,0,1
"PLSCR1",8,1,7,0,1
"RND1",2,1,1,0,1
"PNKP",3,1,2,0,1
"TAF15",6,3,3,0,1
"TNNT1",12,6,6,0,1
"PPFIA3",4,2,2,0,1
"PPP1R12C",8,7,1,0,1
"WBP11",6,3,3,0,1
"STMN1",16,14,2,0,1
"PTCH1",4,3,1,0,1
"PTGDS",4,2,2,0,1
"SDCBP",9,6,3,0,1
"STX4",12,8,4,0,1
"RAD52",4,2,2,0,1
"SFI1",2,1,1,0,1
"RHOQ",7,1,6,0,1
"SYT1",9,5,4,0,1
"RINT1",5,3,2,0,1
"STK11",7,4,3,0,1
"RTN4IP1",2,1,1,0,1
"SERPINE1",29,22,7,0,1
"SIVA1",4,3,1,0,1
"SLC9A3R1",11,3,8,0,1
"SMAD5",20,11,9,0,1
"SMAD9",34,1,33,0,1
"UPF1",11,7,4,0,1
"SNAP23",17,10,7,0,1
"SNTB2",20,12,8,0,1
"SPINT1",3,2,1,0,1
"USP8",7,5,2,0,1
"SYT7",4,2,2,0,1
"VHL",15,9,6,0,1
"TCEB2",8,3,5,0,1
"THAP1",15,10,5,0,1
"TLR1",6,1,5,0,1
"TNFSF13",5,3,2,0,1
"TNFRSF4",5,1,4,0,1
"TNPO2",10,9,1,0,1
"NFATC3",11,9,2,0,1
"TXNDC17",3,1,2,0,1
"ZBTB43",5,4,1,0,1
"ZNF417",5,3,2,0,1
"ZNF165",2,1,1,0,1
"ZNF250",6,4,2,0,1
"hsa-miR-17-5p",601,37,564,0,1
"hsa-miR-18a-5p",255,36,219,0,1
"RUNX3",16,4,12,0,1
"hsa-miR-200c-5p",222,25,197,0,1
"hsa-miR-20a-5p",365,30,335,0,1
"hsa-miR-20b-5p",64,2,62,0,1
"hsa-miR-21-5p",191,28,163,0,1
"hsa-miR-214-5p",70,8,62,0,1
"hsa-miR-221-5p",170,5,165,0,1
"hsa-miR-30c-5p",151,14,137,0,1
"hsa-miR-30e-5p",311,22,289,0,1
"hsa-miR-31-5p",16,1,15,0,1
"hsa-miR-338-5p",40,4,36,0,1
"hsa-miR-33a-5p",27,4,23,0,1
"hsa-miR-3646",3,2,1,0,1
"hsa-miR-425-5p",41,4,37,0,1
"hsa-miR-4638-5p",23,12,11,0,1
"hsa-miR-4772-5p",36,7,29,0,1
"hsa-miR-4778-5p",3,1,2,0,1
"hsa-miR-6759-5p",28,22,6,0,1
