"Name","K","Kin","Kout","TypeI","TypeII"
"ANXA7",64,50,14,0,1
"A2M",26,11,15,0,1
"ATF7IP",94,77,17,0,1
"CDKN1A",96,90,6,0,1
"H2AFX",58,52,6,0,1
"HMOX2",19,13,6,0,1
"MYOC",15,5,10,0,1
"TGFBI",20,17,3,0,1
"TK1",81,59,22,0,1
"MAP1LC3B",29,25,4,0,1
"MDFI",47,41,6,0,1
"RB1",133,112,21,0,1
"ABCA1",63,57,6,0,1
"CSNK2A1",146,123,23,0,1
"FADD",25,20,5,0,1
"MPP6",48,47,1,0,1
"HAX1",16,13,3,0,1
"RDX",55,51,4,0,1
"STX1A",24,17,7,0,1
"NCK2",34,29,5,0,1
"WASF1",28,27,1,0,1
"ABI3",7,6,1,0,1
"ABL1",78,50,28,0,1
"CAV1",99,73,26,0,1
"CDK5",30,23,7,0,1
"CRK",122,99,23,0,1
"MAPT",52,46,6,0,1
"POLR2A",75,66,9,0,1
"PRKD1",37,32,5,0,1
"PRKDC",62,55,7,0,1
"PTPN12",38,37,1,0,1
"RAN",99,86,13,0,1
"XRCC6",57,46,11,0,1
"YWHAE",92,84,8,0,1
"VIM",95,71,24,0,1
"FBLN1",15,12,3,0,1
"USP7",38,34,4,0,1
"YWHAG",179,146,33,0,1
"CTNNB1",112,90,22,0,1
"FYN",152,95,57,0,1
"SPTAN1",28,20,8,0,1
"MYLK",70,67,3,0,1
"VASP",33,29,4,0,1
"VCL",138,109,29,0,1
"ACTB",120,97,23,0,1
"CFL1",22,19,3,0,1
"EMD",29,25,4,0,1
"RCC1",38,32,6,0,1
"DMD",59,55,4,0,1
"DYNLL1",30,24,6,0,1
"GSN",40,32,8,0,1
"PDPK1",92,85,7,0,1
"PIP4K2C",45,40,5,0,1
"RPS6KA5",75,71,4,0,1
"ACTN1",48,40,8,0,1
"COIL",64,58,6,0,1
"ZYX",30,27,3,0,1
"CAMK2A",38,36,2,0,1
"ACTN4",53,50,3,0,1
"CHD3",45,32,13,0,1
"DCTN1",15,13,2,0,1
"CDC42",71,51,20,0,1
"ACVR1",71,54,17,0,1
"RAP2A",34,29,5,0,1
"ACVR1B",69,66,3,0,1
"ACVR2A",77,75,2,0,1
"BMP6",11,10,1,0,1
"BMP7",31,27,4,0,1
"TGFB1",36,24,12,0,1
"TGFB3",13,10,3,0,1
"TGFBR1",133,95,38,0,1
"TGFBR2",140,126,14,0,1
"GRB2",102,64,38,0,1
"SH3D19",65,63,2,0,1
"NOTCH1",60,55,5,0,1
"TNFSF11",25,19,6,0,1
"FN1",99,80,19,0,1
"PRKCA",126,69,57,0,1
"RAF1",44,35,9,0,1
"ADCYAP1",27,26,1,0,1
"CALM1",97,90,7,0,1
"PRKCD",51,34,17,0,1
"APPL1",52,46,6,0,1
"GNAZ",8,6,2,0,1
"SLC9A3R2",32,27,5,0,1
"RGS2",29,13,16,0,1
"GNAI2",63,59,4,0,1
"YWHAZ",181,141,40,0,1
"GNAO1",17,13,4,0,1
"ADRB2",24,16,8,0,1
"ARRB1",53,45,8,0,1
"GNA11",26,21,5,0,1
"GPRASP1",25,9,16,0,1
"GRK5",39,31,8,0,1
"SLC9A3R1",37,24,13,0,1
"SRC",51,30,21,0,1
"GIT1",51,41,10,0,1
"PRKCB",59,47,12,0,1
"PRKCE",44,37,7,0,1
"ATXN1L",85,76,9,0,1
"MLLT1",60,56,4,0,1
"SGSM2",33,28,5,0,1
"UBE3A",56,52,4,0,1
"CCDC85B",72,59,13,0,1
"AGTR1",10,7,3,0,1
"ARNT",56,31,25,0,1
"EP300",163,142,21,0,1
"NCOA1",113,74,39,0,1
"NCOA2",71,58,13,0,1
"SMARCA4",47,26,21,0,1
"AIP",17,16,1,0,1
"PRKAR2A",66,60,6,0,1
"AKAP10",44,39,5,0,1
"PRKAR1A",69,55,14,0,1
"GSK3B",132,99,33,0,1
"YWHAB",104,83,21,0,1
"IQGAP1",52,44,8,0,1
"KPNB1",87,74,13,0,1
"PRPF40A",75,60,15,0,1
"AKAP9",43,39,4,0,1
"PKN1",18,16,2,0,1
"AKT1",61,45,16,0,1
"BAD",20,10,10,0,1
"CHUK",49,35,14,0,1
"TSC2",22,20,2,0,1
"BCL2A1",6,4,2,0,1
"HSP90AA1",107,85,22,0,1
"IGSF21",9,6,3,0,1
"XRN1",62,56,6,0,1
"JAK3",35,19,16,0,1
"PLCG1",77,53,24,0,1
"PTN",32,12,20,0,1
"PTPRZ1",15,11,4,0,1
"CRMP1",39,26,13,0,1
"TOM1L1",11,5,6,0,1
"AMOTL2",63,61,2,0,1
"DNM1",22,18,4,0,1
"CSNK2B",59,25,34,0,1
"TEK",19,10,9,0,1
"NFASC",23,22,1,0,1
"ANK2",28,27,1,0,1
"SPTBN1",60,56,4,0,1
"ANK3",36,34,2,0,1
"HDAC4",53,50,3,0,1
"LRP2",23,14,9,0,1
"ANXA1",19,12,7,0,1
"COPS6",53,35,18,0,1
"TGM2",22,17,5,0,1
"UNC119",45,24,21,0,1
"ANXA11",39,38,1,0,1
"S100A6",5,4,1,0,1
"MED31",22,19,3,0,1
"RBBP4",65,59,6,0,1
"AP1M1",27,20,7,0,1
"AP2B1",60,50,10,0,1
"AP2A1",33,27,6,0,1
"HTT",63,51,12,0,1
"AP2M1",32,29,3,0,1
"MEGF10",3,2,1,0,1
"AP3B1",41,38,3,0,1
"CLTC",103,89,14,0,1
"ARF1",58,51,7,0,1
"TGOLN2",78,75,3,0,1
"CASP3",91,55,36,0,1
"HSPA1A",46,37,9,0,1
"APP",105,83,22,0,1
"STXBP1",17,14,3,0,1
"SIAH1",20,18,2,0,1
"PCNA",79,70,9,0,1
"UBE2I",71,61,10,0,1
"APOA1",9,5,4,0,1
"MAPK6",122,93,29,0,1
"KPNA2",79,75,4,0,1
"LRP1",54,41,13,0,1
"COL4A2",41,38,3,0,1
"HSPG2",35,30,5,0,1
"PSEN2",16,10,6,0,1
"SHC1",51,37,14,0,1
"SNCA",25,15,10,0,1
"APPBP2",47,45,2,0,1
"EFEMP2",25,20,5,0,1
"CCND1",174,167,7,0,1
"CDC37",45,40,5,0,1
"CREBBP",300,84,216,0,1
"GTF2H1",28,26,2,0,1
"KAT2B",57,51,6,0,1
"NCOR2",95,55,40,0,1
"SMAD1",200,31,169,0,1
"SMAD3",176,47,129,0,1
"ARPC3",24,23,1,0,1
"ARRB2",37,23,14,0,1
"HSP90AB1",47,46,1,0,1
"ITPR1",48,41,7,0,1
"PIK3R1",144,97,47,0,1
"RASA1",69,50,19,0,1
"RHOA",68,53,15,0,1
"TUBA4A",19,11,8,0,1
"SMURF2",73,57,16,0,1
"ARHGDIA",60,58,2,0,1
"CBX5",137,132,5,0,1
"VAV1",38,29,9,0,1
"GNA13",58,49,9,0,1
"ARHGEF12",51,45,6,0,1
"ARHGEF7",31,26,5,0,1
"CBLB",48,40,8,0,1
"SMARCE1",24,22,2,0,1
"E2F1",656,65,591,0,1
"SIN3A",59,53,6,0,1
"GAPDH",68,52,16,0,1
"UBR1",38,28,10,0,1
"ATP5J2",10,8,2,0,1
"WAS",25,12,13,0,1
"RNF130",7,6,1,0,1
"MDM2",156,145,11,0,1
"FLNA",66,56,10,0,1
"HIPK3",108,102,6,0,1
"MAPK1",170,144,26,0,1
"HCK",38,26,12,0,1
"SH3KBP1",47,43,4,0,1
"BIN1",15,11,4,0,1
"TBC1D17",16,15,1,0,1
"ASF1A",35,34,1,0,1
"ASGR1",17,15,2,0,1
"DHFR",12,11,1,0,1
"PFDN1",13,8,5,0,1
"CREB1",437,89,348,0,1
"GABPB1",80,74,6,0,1
"SPI1",366,19,347,0,1
"BATF3",6,5,1,0,1
"JUN",385,61,324,0,1
"DDIT3",20,13,7,0,1
"NFE2L1",59,58,1,0,1
"NFE2L2",89,28,61,0,1
"CDC34",21,20,1,0,1
"DISC1",38,37,1,0,1
"LUC7L2",47,39,8,0,1
"SETDB1",34,29,5,0,1
"EIF4EBP1",50,47,3,0,1
"STK11",42,37,5,0,1
"TOPBP1",25,22,3,0,1
"WRN",25,22,3,0,1
"XRCC5",49,43,6,0,1
"ATN1",46,31,15,0,1
"DMPK",29,26,3,0,1
"EWSR1",43,25,18,0,1
"RASSF1",19,13,6,0,1
"ATP5C1",20,18,2,0,1
"CDK4",93,83,10,0,1
"ATR",20,15,5,0,1
"EZH2",339,38,301,0,1
"ATXN1",173,149,24,0,1
"ATXN2",40,37,3,0,1
"CDK6",150,148,2,0,1
"DAZAP2",104,98,6,0,1
"RAD23A",24,18,6,0,1
"ITGA2B",3,2,1,0,1
"RNF11",104,85,19,0,1
"AURKA",61,56,5,0,1
"CDC20",23,20,3,0,1
"NME1",22,18,4,0,1
"PPP1CA",37,31,6,0,1
"PPP1CC",67,66,1,0,1
"AVPR1A",16,14,2,0,1
"AXIN1",33,19,14,0,1
"JUP",22,19,3,0,1
"CBL",101,74,27,0,1
"IL2RG",11,8,3,0,1
"LCK",68,36,32,0,1
"SOCS1",54,43,11,0,1
"B2M",32,31,1,0,1
"BACH1",147,104,43,0,1
"BCL2L1",59,51,8,0,1
"MAPK8",83,76,7,0,1
"RPS6KA1",30,29,1,0,1
"YWHAQ",83,71,12,0,1
"BCL2",97,84,13,0,1
"BAHD1",68,67,1,0,1
"DLG4",51,25,26,0,1
"PHYHIP",44,37,7,0,1
"BAIAP2",14,10,4,0,1
"CREB3L3",3,2,1,0,1
"BID",41,34,7,0,1
"MAP3K7",58,50,8,0,1
"BCAR1",40,33,7,0,1
"CD2AP",87,84,3,0,1
"TRIP6",20,13,7,0,1
"FAM46A",43,41,2,0,1
"BCL10",30,22,8,0,1
"IKBKG",49,44,5,0,1
"CYCS",83,82,1,0,1
"PPP2CA",84,75,9,0,1
"FOS",431,62,369,0,1
"NFKB2",80,11,69,0,1
"RUNX1T1",285,109,176,0,1
"ERCC3",14,13,1,0,1
"PTPN11",86,52,34,0,1
"BMP4",12,8,4,0,1
"BICD2",47,45,2,0,1
"NEK9",85,84,1,0,1
"RAB6A",12,11,1,0,1
"DNM2",42,38,4,0,1
"BIRC2",25,15,10,0,1
"DIABLO",24,21,3,0,1
"UBB",44,33,11,0,1
"BLK",3,2,1,0,1
"SUMO2",47,41,6,0,1
"BLNK",15,12,3,0,1
"RING1",14,11,3,0,1
"RNF2",38,35,3,0,1
"COL1A1",69,56,13,0,1
"BMPR2",105,94,11,0,1
"ROBO2",41,33,8,0,1
"BRCA2",18,14,4,0,1
"CDK2",98,90,8,0,1
"CDK7",12,10,2,0,1
"KPNA1",80,77,3,0,1
"NFYA",214,44,170,0,1
"RFC1",25,23,2,0,1
"BRMS1",9,5,4,0,1
"EGFR",133,90,43,0,1
"BTK",46,9,37,0,1
"KIT",63,37,26,0,1
"LYN",99,64,35,0,1
"MYD88",25,20,5,0,1
"PLCG2",75,60,15,0,1
"PRKCQ",15,9,6,0,1
"PRKCZ",30,14,16,0,1
"SYK",54,24,30,0,1
"BTRC",74,63,11,0,1
"SKP1",54,50,4,0,1
"SUFU",34,33,1,0,1
"BUB1",48,44,4,0,1
"PLK1",57,38,19,0,1
"BUB1B",12,10,2,0,1
"EHMT2",16,15,1,0,1
"C11orf58",39,33,6,0,1
"EEF1G",34,18,16,0,1
"KIAA1377",47,20,27,0,1
"RPLP1",43,36,7,0,1
"C14orf1",34,29,5,0,1
"TSNAX",24,22,2,0,1
"DCN",23,15,8,0,1
"UBQLN4",48,29,19,0,1
"CTSG",15,7,8,0,1
"CEP70",18,13,5,0,1
"C8orf33",44,41,3,0,1
"FEZ1",17,6,11,0,1
"IMMT",32,22,10,0,1
"CCNE1",45,39,6,0,1
"MPP3",6,5,1,0,1
"CALCOCO2",40,34,6,0,1
"GPRASP2",23,12,11,0,1
"PLAT",24,22,2,0,1
"THBS1",110,100,10,0,1
"TRAF6",69,42,27,0,1
"CAMLG",34,30,4,0,1
"KCNA3",9,7,2,0,1
"RYR1",9,5,4,0,1
"EBI3",14,13,1,0,1
"CAPNS1",22,17,5,0,1
"CAPRIN1",68,67,1,0,1
"RPP14",42,40,2,0,1
"TRAF1",62,48,14,0,1
"CASK",46,36,10,0,1
"EPB41",64,47,17,0,1
"PRKD2",23,20,3,0,1
"CASP1",16,9,7,0,1
"PLA2G4A",36,30,6,0,1
"CASP8",49,32,17,0,1
"EIF2AK2",60,47,13,0,1
"ROCK1",58,54,4,0,1
"TOP1",30,28,2,0,1
"CASP4",14,8,6,0,1
"RIPK1",10,7,3,0,1
"RYBP",100,97,3,0,1
"HRAS",48,25,23,0,1
"ILK",34,27,7,0,1
"IRS1",80,67,13,0,1
"PTEN",100,97,3,0,1
"STRN4",29,24,5,0,1
"CD5",18,14,4,0,1
"INSR",75,50,25,0,1
"ITCH",31,29,2,0,1
"KRT18",23,18,5,0,1
"PIK3R2",19,14,5,0,1
"UBE2L3",16,14,2,0,1
"TRIM24",42,34,8,0,1
"CBX2",61,60,1,0,1
"TAF4",36,30,6,0,1
"MCM10",33,26,7,0,1
"CCR5",37,29,8,0,1
"MMP1",15,12,3,0,1
"MMP3",14,11,3,0,1
"VCAM1",35,32,3,0,1
"CXCL13",9,7,2,0,1
"CCR1",9,7,2,0,1
"VCAN",73,61,12,0,1
"CCL21",6,4,2,0,1
"GOT2",26,22,4,0,1
"DPP4",18,11,7,0,1
"CCR3",12,6,6,0,1
"IL8",20,19,1,0,1
"SDC1",31,27,4,0,1
"CDC25A",79,76,3,0,1
"CDC25C",15,10,5,0,1
"GADD45G",30,20,10,0,1
"PTMA",59,44,15,0,1
"JAK1",72,48,24,0,1
"JAK2",61,35,26,0,1
"CD4",54,40,14,0,1
"CXCR4",26,16,10,0,1
"PTK2B",40,23,17,0,1
"SOD1",12,11,1,0,1
"PAFAH1B2",90,88,2,0,1
"RAP1B",68,66,2,0,1
"ITGB2",28,9,19,0,1
"ITGB1",90,64,26,0,1
"CD79A",12,7,5,0,1
"CD79B",9,5,4,0,1
"CD2",12,8,4,0,1
"PSTPIP1",10,9,1,0,1
"CD244",10,8,2,0,1
"LAT",20,10,10,0,1
"CD247",19,6,13,0,1
"CSK",35,28,7,0,1
"TRAF3",32,29,3,0,1
"CD28",40,28,12,0,1
"GRAP2",60,50,10,0,1
"PIK3CG",35,30,5,0,1
"CD3E",18,13,5,0,1
"IL16",19,14,5,0,1
"PTK2",60,42,18,0,1
"SIRPA",39,36,3,0,1
"UBQLN1",44,36,8,0,1
"CD48",11,7,4,0,1
"IL2",9,8,1,0,1
"SDCBP",48,42,6,0,1
"VANGL1",70,67,3,0,1
"COL4A3",30,24,6,0,1
"MELK",63,62,1,0,1
"SAFB",24,18,6,0,1
"ITSN1",59,52,7,0,1
"PRKCI",27,21,6,0,1
"TNK2",32,31,1,0,1
"CSE1L",56,54,2,0,1
"CDH2",44,40,4,0,1
"CDH5",36,30,6,0,1
"CDK9",44,35,9,0,1
"CDKN1B",74,69,5,0,1
"PAX6",26,22,4,0,1
"HDAC2",39,37,2,0,1
"GATA2",220,17,203,0,1
"MYB",322,27,295,0,1
"SMARCC1",53,38,15,0,1
"TAF9",22,16,6,0,1
"GARS",38,37,1,0,1
"SPTBN4",28,24,4,0,1
"PIN1",56,40,16,0,1
"SMN1",33,11,22,0,1
"NEK2",12,9,3,0,1
"LIMK1",30,29,1,0,1
"DAXX",21,17,4,0,1
"IKBKB",30,26,4,0,1
"TRIM28",42,41,1,0,1
"CHFR",18,15,3,0,1
"PML",26,17,9,0,1
"CHM",9,8,1,0,1
"CHMP2A",10,8,2,0,1
"CHMP4B",34,30,4,0,1
"MAPK8IP2",30,22,8,0,1
"CIB1",7,5,2,0,1
"TYROBP",7,5,2,0,1
"HGS",35,20,15,0,1
"CNKSR1",6,4,2,0,1
"CNOT7",35,33,2,0,1
"GNAI1",43,31,12,0,1
"MET",66,51,15,0,1
"PTPRB",39,36,3,0,1
"CNTNAP2",19,18,1,0,1
"COL17A1",7,4,3,0,1
"PPL",29,27,2,0,1
"KDR",50,31,19,0,1
"IGFBP3",43,36,7,0,1
"COL2A1",17,12,5,0,1
"COL3A1",34,30,4,0,1
"PXN",46,33,13,0,1
"XRN2",19,16,3,0,1
"STX8",6,5,1,0,1
"MAPK14",95,83,12,0,1
"TRIM37",53,48,5,0,1
"GPS1",19,14,5,0,1
"POLA2",48,44,4,0,1
"TAF11",25,21,4,0,1
"NUDT21",42,34,8,0,1
"WWP1",33,30,3,0,1
"NFIL3",19,18,1,0,1
"EBF1",304,43,261,0,1
"ETS1",355,76,279,0,1
"PROX1",61,51,10,0,1
"SNIP1",50,47,3,0,1
"UBTF",128,48,80,0,1
"IRS2",44,39,5,0,1
"EEF1D",44,40,4,0,1
"EIF2S2",46,42,4,0,1
"PER1",76,72,4,0,1
"CSF1",36,33,3,0,1
"INPP5D",16,8,8,0,1
"CSF2",3,2,1,0,1
"CSF2RB",20,10,10,0,1
"FES",11,8,3,0,1
"HNRNPK",53,44,9,0,1
"CSNK1G2",19,18,1,0,1
"HDAC3",16,13,3,0,1
"PPP1R8",18,12,6,0,1
"NAP1L4",25,23,2,0,1
"ERCC8",11,9,2,0,1
"LYST",27,24,3,0,1
"CTBP2",25,24,1,0,1
"CTCF",409,33,376,0,1
"SNRNP70",24,21,3,0,1
"CTGF",54,52,2,0,1
"NOV",15,11,4,0,1
"PPP2R5A",27,23,4,0,1
"RUVBL1",15,14,1,0,1
"ZFYVE9",31,27,4,0,1
"FAM118B",14,13,1,0,1
"CTTN",35,32,3,0,1
"LGALS3",16,14,2,0,1
"NCF4",6,5,1,0,1
"FMR1",46,44,2,0,1
"FXR2",31,27,4,0,1
"TRIM23",41,35,6,0,1
"DAG1",38,34,4,0,1
"MCM3",41,35,6,0,1
"MCM7",61,52,9,0,1
"DDR2",41,38,3,0,1
"GOLM1",26,25,1,0,1
"HSPD1",46,41,5,0,1
"PTCH1",30,29,1,0,1
"ILF3",35,34,1,0,1
"DLG1",37,15,22,0,1
"MAPK12",10,5,5,0,1
"DLG2",53,36,17,0,1
"NOS1",22,16,6,0,1
"KCNJ10",25,24,1,0,1
"DLST",22,20,2,0,1
"FLII",16,14,2,0,1
"SOX8",15,10,5,0,1
"RPS10",18,15,3,0,1
"DNAJC3",38,35,3,0,1
"HSPA1B",45,44,1,0,1
"PSEN1",46,32,14,0,1
"PPP2CB",21,20,1,0,1
"KIAA1279",29,25,4,0,1
"DPYSL2",47,46,1,0,1
"DST",89,85,4,0,1
"KRT5",7,4,3,0,1
"MAPK11",9,8,1,0,1
"DUSP23",13,8,5,0,1
"PRPF3",6,4,2,0,1
"PNN",27,22,5,0,1
"DYNLL2",77,75,2,0,1
"E2F6",379,39,340,0,1
"TFDP1",40,36,4,0,1
"TFDP2",68,65,3,0,1
"E2F2",94,83,11,0,1
"E2F3",224,116,108,0,1
"ECH1",12,10,2,0,1
"RHOG",25,22,3,0,1
"EDA",6,5,1,0,1
"EEF1A1",73,59,14,0,1
"EXOSC4",19,9,10,0,1
"GADD45A",30,23,7,0,1
"EFNA1",45,44,1,0,1
"EFNA3",28,27,1,0,1
"PRSS23",29,24,5,0,1
"EFNA4",7,6,1,0,1
"MAP2K4",46,41,5,0,1
"RGS3",14,12,2,0,1
"HOMER1",34,26,8,0,1
"PTPN13",24,21,3,0,1
"PLSCR1",43,31,12,0,1
"SNRPD2",19,11,8,0,1
"TRIM27",27,25,2,0,1
"EIF2B5",21,19,2,0,1
"RPL6",8,7,1,0,1
"NMI",14,13,1,0,1
"TES",59,54,5,0,1
"NUMA1",16,15,1,0,1
"GNB2L1",40,36,4,0,1
"GRAP",10,8,2,0,1
"SYNCRIP",96,95,1,0,1
"HOOK2",10,9,1,0,1
"ERBB2",32,27,5,0,1
"ERCC5",8,5,3,0,1
"PIK3CB",53,45,8,0,1
"THRA",84,79,5,0,1
"PSMC5",21,19,2,0,1
"ETF1",33,32,1,0,1
"EXOSC10",11,8,3,0,1
"RAB27A",42,36,6,0,1
"S100P",5,4,1,0,1
"F10",11,8,3,0,1
"SGTA",16,11,5,0,1
"F2R",40,33,7,0,1
"ITGAV",47,38,9,0,1
"F2RL2",29,26,3,0,1
"RABAC1",44,33,11,0,1
"RAP1A",46,36,10,0,1
"TNFRSF1A",35,19,16,0,1
"FCER1G",10,5,5,0,1
"FCGR1A",5,2,3,0,1
"ZAP70",30,5,25,0,1
"FGF1",44,40,4,0,1
"FGFR1",48,44,4,0,1
"RPS6KA3",117,106,11,0,1
"FGFR3",21,12,9,0,1
"FIGF",5,3,2,0,1
"GATA1",378,5,373,0,1
"TTN",12,8,4,0,1
"FLNB",29,26,3,0,1
"FLOT2",25,24,1,0,1
"VHL",49,43,6,0,1
"FOXA2",124,2,122,0,1
"PPARG",174,22,152,0,1
"NR1H3",59,10,49,0,1
"MPHOSPH6",14,11,3,0,1
"TAF10",24,14,10,0,1
"GIPC1",32,24,8,0,1
"RYK",21,20,1,0,1
"MAP3K3",64,61,3,0,1
"GABARAP",15,11,4,0,1
"SH3GL3",10,1,9,0,1
"PPP3CA",43,37,6,0,1
"GNAQ",64,54,10,0,1
"IARS",27,26,1,0,1
"MBD3",418,41,377,0,1
"GDI2",31,30,1,0,1
"NCAM1",26,22,4,0,1
"PDLIM7",18,15,3,0,1
"RET",30,18,12,0,1
"GGA1",39,35,4,0,1
"GGA2",48,41,7,0,1
"GHRL",3,1,2,0,1
"RGS19",19,13,6,0,1
"ZIC1",11,8,3,0,1
"NUDT18",25,20,5,0,1
"TRPC3",24,17,7,0,1
"RGS4",23,21,2,0,1
"PLCB1",31,27,4,0,1
"GOLGA2",35,28,7,0,1
"IGF2",66,60,6,0,1
"LRSAM1",15,10,5,0,1
"STUB1",15,4,11,0,1
"GPRIN2",14,12,2,0,1
"GRASP",8,5,3,0,1
"USP8",28,26,2,0,1
"GRK6",25,21,4,0,1
"TUBA1B",42,41,1,0,1
"SGK1",67,64,3,0,1
"KIF5B",70,68,2,0,1
"RAC1",73,61,12,0,1
"HAND2",80,34,46,0,1
"TCF3",408,28,380,0,1
"MMP2",64,45,19,0,1
"MMP7",10,2,8,0,1
"HCST",2,1,1,0,1
"HEXDC",5,3,2,0,1
"SMAD7",76,65,11,0,1
"PLAU",19,15,4,0,1
"HIPK2",49,45,4,0,1
"HMGXB4",43,42,1,0,1
"NR1H2",52,13,39,0,1
"HNRNPA1",75,70,5,0,1
"TNPO1",111,107,4,0,1
"MEIS1",56,48,8,0,1
"PBX1",226,52,174,0,1
"HOXC8",49,47,2,0,1
"SMAD6",26,24,2,0,1
"IRAK2",19,17,2,0,1
"HSPBP1",8,7,1,0,1
"NUAK1",51,46,5,0,1
"PSME3",55,50,5,0,1
"HSPB2",5,4,1,0,1
"S1PR1",77,74,3,0,1
"HTRA1",18,12,6,0,1
"IFNAR1",45,37,8,0,1
"IFNAR2",75,72,3,0,1
"IGBP1",15,13,2,0,1
"IGF1",126,124,2,0,1
"IGFBP5",79,75,4,0,1
"IL12B",7,6,1,0,1
"IL4R",16,7,9,0,1
"IL18",8,5,3,0,1
"IL1RAP",43,35,8,0,1
"NDN",22,17,5,0,1
"TICAM2",13,8,5,0,1
"NGFR",43,31,12,0,1
"IL21",2,1,1,0,1
"PTPN6",47,12,35,0,1
"IL5RA",18,13,5,0,1
"IRF3",35,17,18,0,1
"IRF4",98,40,58,0,1
"ITGB7",7,3,4,0,1
"ITGB5",29,17,12,0,1
"VTN",7,3,4,0,1
"PRKG1",52,42,10,0,1
"PPIA",38,35,3,0,1
"TJP1",60,51,9,0,1
"SKI",131,125,6,0,1
"KCNA2",10,8,2,0,1
"SNAP25",32,30,2,0,1
"KHSRP",104,100,4,0,1
"KLRD1",26,25,1,0,1
"LANCL1",23,22,1,0,1
"LEF1",43,22,21,0,1
"LEPR",29,18,11,0,1
"SHANK1",12,2,10,0,1
"RTN4",46,41,5,0,1
"LSM2",8,3,5,0,1
"LSM4",22,17,5,0,1
"LSM5",15,11,4,0,1
"LTB",12,10,2,0,1
"TRAF2",81,17,64,0,1
"MED12",16,14,2,0,1
"PDX1",13,2,11,0,1
"MAFG",39,36,3,0,1
"MAP1B",114,105,9,0,1
"MAP3K2",101,99,2,0,1
"MAP3K5",45,34,11,0,1
"PPP2R1A",31,28,3,0,1
"MAPK8IP3",37,29,8,0,1
"TTF2",59,50,9,0,1
"MAZ",466,83,383,0,1
"ZNF512B",73,66,7,0,1
"MBP",16,8,8,0,1
"MECP2",91,72,19,0,1
"MED9",13,10,3,0,1
"MEF2A",78,41,37,0,1
"MMP14",37,25,12,0,1
"MRPS9",7,6,1,0,1
"SELPLG",25,22,3,0,1
"MST1",2,1,1,0,1
"ZFHX3",101,100,1,0,1
"RAB11A",57,55,2,0,1
"NOTCH2",81,71,10,0,1
"NR1D2",37,35,2,0,1
"PSMD4",12,10,2,0,1
"RELB",22,10,12,0,1
"NTRK1",8,3,5,0,1
"VTA1",46,43,3,0,1
"NLGN3",10,8,2,0,1
"SFPQ",204,67,137,0,1
"STX4",42,36,6,0,1
"SQSTM1",44,43,1,0,1
"NUDT3",90,81,9,0,1
"NUP98",44,38,6,0,1
"OSMR",48,43,5,0,1
"PABPC1",69,63,6,0,1
"POLA1",14,11,3,0,1
"BACH2",117,89,28,0,1
"WT1",26,23,3,0,1
"YBX1",35,30,5,0,1
"PCYT2",15,14,1,0,1
"RAD50",27,24,3,0,1
"PDE4D",85,84,1,0,1
"PDGFRB",41,22,19,0,1
"PEA15",32,31,1,0,1
"PEX5",17,15,2,0,1
"SNUPN",7,4,3,0,1
"PFN2",55,52,3,0,1
"SCMH1",7,5,2,0,1
"RND1",2,1,1,0,1
"POLR3F",25,23,2,0,1
"PORCN",6,5,1,0,1
"WNT5B",10,9,1,0,1
"WBP11",29,25,4,0,1
"PPP1R9B",24,22,2,0,1
"PRKD3",52,51,1,0,1
"XPA",6,5,1,0,1
"PTGDS",7,4,3,0,1
"PTGFR",22,20,2,0,1
"PTPRD",75,72,3,0,1
"RAB3IL1",7,6,1,0,1
"RAB3A",8,5,3,0,1
"RABGGTB",18,17,1,0,1
"RAB9A",20,19,1,0,1
"SPG21",10,8,2,0,1
"RALY",26,25,1,0,1
"RFX1",37,31,6,0,1
"RFX2",11,9,2,0,1
"SYT1",39,36,3,0,1
"SCARB1",20,19,1,0,1
"SDCBP2",3,1,2,0,1
"SMAD5",92,83,9,0,1
"SKIL",90,66,24,0,1
"SOX5",59,57,2,0,1
"SMG5",16,15,1,0,1
"UPF1",22,18,4,0,1
"SNAP23",45,38,7,0,1
"SOX4",93,90,3,0,1
"SOX6",67,66,1,0,1
"ZBTB7A",375,135,240,0,1
"STAT3",403,69,334,0,1
"YEATS4",14,13,1,0,1
"TNFSF12",4,3,1,0,1
"TNFRSF14",16,10,6,0,1
"TNFRSF4",5,1,4,0,1
"WIZ",40,37,3,0,1
"ZBTB43",61,60,1,0,1
"ZNF417",49,47,2,0,1
"ZNF165",3,2,1,0,1
"ZNF250",22,20,2,0,1
"TCF7L2",272,62,210,0,1
"FOXF2",40,37,3,0,1
"hsa-miR-130a-5p",917,30,887,0,1
"hsa-miR-132-5p",278,28,250,0,1
"hsa-miR-141-5p",589,60,529,0,1
"hsa-miR-146a-5p",326,68,258,0,1
"hsa-miR-21-5p",646,96,550,0,1
"hsa-miR-22-5p",818,79,739,0,1
"hsa-miR-223-5p",262,35,227,0,1
"hsa-miR-29b-2-5p",79,58,21,0,1
"hsa-miR-3137",43,36,7,0,1
"hsa-miR-342-5p",407,51,356,0,1
"hsa-miR-34a-5p",935,31,904,0,1
"hsa-miR-3614-5p",129,76,53,0,1
"hsa-miR-3648",154,151,3,0,1
"hsa-miR-3652",115,56,59,0,1
"hsa-miR-373-5p",144,4,140,0,1
"hsa-miR-429",498,34,464,0,1
"hsa-miR-4657",69,60,9,0,1
"hsa-miR-584-5p",78,35,43,0,1
"hsa-miR-663a",138,105,33,0,1
"hsa-miR-6728-5p",125,82,43,0,1
"hsa-miR-6797-5p",132,71,61,0,1
