"Name","K","Kin","Kout","TypeI","TypeII","Type"
"ANXA7",69,49,20,0,1,"coding"
"A2M",28,11,17,0,1,"coding"
"ATF7IP",60,38,22,0,1,"coding"
"CDKN1A",92,74,18,0,1,"coding"
"H2AFX",40,34,6,0,1,"coding"
"HMOX2",16,8,8,0,1,"coding"
"MYOC",19,7,12,0,1,"coding"
"SMN1",55,26,29,0,1,"coding"
"TGFBI",15,12,3,0,1,"coding"
"TK1",105,76,29,0,1,"coding"
"MAP1LC3B",20,15,5,0,1,"coding"
"MDFI",50,42,8,0,1,"coding"
"RB1",133,110,23,0,1,"coding"
"ABCA1",51,45,6,0,1,"coding"
"CSNK2A1",120,93,27,0,1,"coding"
"FADD",24,13,11,0,1,"coding"
"MPP6",32,27,5,0,1,"coding"
"HAX1",15,12,3,0,1,"coding"
"RDX",30,24,6,0,1,"coding"
"STX1A",24,14,10,0,1,"coding"
"EPS8",29,21,8,0,1,"coding"
"HSPA8",60,41,19,0,1,"coding"
"NCK2",33,21,12,0,1,"coding"
"SOS1",52,32,20,0,1,"coding"
"SOS2",21,16,5,0,1,"coding"
"WASF1",21,17,4,0,1,"coding"
"KRT15",32,28,4,0,1,"coding"
"ABL1",79,47,32,0,1,"coding"
"ATM",43,25,18,0,1,"coding"
"BCAR1",40,30,10,0,1,"coding"
"CASP9",29,21,8,0,1,"coding"
"CAV1",102,66,36,0,1,"coding"
"CDK5",30,23,7,0,1,"coding"
"CRK",87,61,26,0,1,"coding"
"MAPT",49,39,10,0,1,"coding"
"POLR2A",64,53,11,0,1,"coding"
"PRKD1",31,24,7,0,1,"coding"
"PTPN12",30,27,3,0,1,"coding"
"RAD51",71,65,6,0,1,"coding"
"RAN",74,61,13,0,1,"coding"
"XRCC6",49,33,16,0,1,"coding"
"YWHAE",67,52,15,0,1,"coding"
"YWHAZ",163,104,59,0,1,"coding"
"ABL2",41,38,3,0,1,"coding"
"VIM",101,70,31,0,1,"coding"
"ATXN1",148,120,28,0,1,"coding"
"FBLN1",15,10,5,0,1,"coding"
"FBLN2",21,17,4,0,1,"coding"
"USP7",36,31,5,0,1,"coding"
"LAMB1",8,7,1,0,1,"coding"
"YWHAG",192,149,43,0,1,"coding"
"CTNNB1",103,80,23,0,1,"coding"
"FYN",153,84,69,0,1,"coding"
"INSR",62,30,32,0,1,"coding"
"LCK",74,39,35,0,1,"coding"
"SPTAN1",27,16,11,0,1,"coding"
"CFL1",21,16,5,0,1,"coding"
"MYLK",66,61,5,0,1,"coding"
"PFN1",43,31,12,0,1,"coding"
"PRKCA",132,63,69,0,1,"coding"
"S100A4",8,5,3,0,1,"coding"
"VASP",23,19,4,0,1,"coding"
"VCL",113,80,33,0,1,"coding"
"ACTB",104,78,26,0,1,"coding"
"BCL2L1",48,40,8,0,1,"coding"
"CSNK1A1",73,64,9,0,1,"coding"
"EMD",21,17,4,0,1,"coding"
"RCC1",36,29,7,0,1,"coding"
"ACTN4",28,22,6,0,1,"coding"
"DMD",46,42,4,0,1,"coding"
"DYNLL1",38,27,11,0,1,"coding"
"GSN",28,20,8,0,1,"coding"
"PDPK1",82,71,11,0,1,"coding"
"PIP4K2C",28,22,6,0,1,"coding"
"RPS6KA5",53,48,5,0,1,"coding"
"ARHGDIA",32,30,2,0,1,"coding"
"ACTN1",50,38,12,0,1,"coding"
"COIL",49,42,7,0,1,"coding"
"MAGEA11",14,8,6,0,1,"coding"
"PKN1",21,17,4,0,1,"coding"
"CAMK2A",38,29,9,0,1,"coding"
"DISC1",25,24,1,0,1,"coding"
"DCTN1",13,10,3,0,1,"coding"
"CHD3",55,40,15,0,1,"coding"
"CDC42",66,38,28,0,1,"coding"
"CTTN",15,11,4,0,1,"coding"
"ACVR1",73,51,22,0,1,"coding"
"AP2B1",46,36,10,0,1,"coding"
"IKBKB",39,29,10,0,1,"coding"
"RAP2A",29,23,6,0,1,"coding"
"STX8",9,8,1,0,1,"coding"
"ACVR2A",49,47,2,0,1,"coding"
"SYNJ2BP",37,33,4,0,1,"coding"
"TGFB1",34,20,14,0,1,"coding"
"TGFB3",13,10,3,0,1,"coding"
"TGFBR1",109,68,41,0,1,"coding"
"TGFBR2",105,89,16,0,1,"coding"
"GRB2",128,65,63,0,1,"coding"
"SH3D19",45,43,2,0,1,"coding"
"TGFA",26,22,4,0,1,"coding"
"ADAM15",11,10,1,0,1,"coding"
"MAD2L1",20,16,4,0,1,"coding"
"NOTCH1",44,38,6,0,1,"coding"
"TNF",13,11,2,0,1,"coding"
"TNFSF11",26,15,11,0,1,"coding"
"RYR1",11,6,5,0,1,"coding"
"MAD2L2",6,2,4,0,1,"coding"
"FN1",92,70,22,0,1,"coding"
"ADCY10",2,1,1,0,1,"coding"
"RAF1",45,31,14,0,1,"coding"
"ADCYAP1",14,13,1,0,1,"coding"
"CALM1",75,53,22,0,1,"coding"
"PRKCD",51,29,22,0,1,"coding"
"APPL1",32,25,7,0,1,"coding"
"GNAZ",8,5,3,0,1,"coding"
"CYTH2",22,16,6,0,1,"coding"
"SLC9A3R2",25,19,6,0,1,"coding"
"RGS2",30,10,20,0,1,"coding"
"GNA11",20,15,5,0,1,"coding"
"ADRBK1",33,17,16,0,1,"coding"
"GNAI2",50,44,6,0,1,"coding"
"GNAO1",15,6,9,0,1,"coding"
"DLG4",64,27,37,0,1,"coding"
"ADRB2",27,15,12,0,1,"coding"
"ARRB1",46,30,16,0,1,"coding"
"GPRASP1",29,11,18,0,1,"coding"
"GRK5",31,22,9,0,1,"coding"
"SLC9A3R1",36,19,17,0,1,"coding"
"SRC",79,37,42,0,1,"coding"
"CAPN2",14,8,6,0,1,"coding"
"CSNK2B",76,32,44,0,1,"coding"
"GIT1",48,33,15,0,1,"coding"
"MAPK3",50,41,9,0,1,"coding"
"PEBP1",32,30,2,0,1,"coding"
"PIK3CG",24,19,5,0,1,"coding"
"CXCR4",26,15,11,0,1,"coding"
"PRKCB",54,35,19,0,1,"coding"
"PRKCE",42,30,12,0,1,"coding"
"PRKCZ",46,22,24,0,1,"coding"
"ATXN1L",57,47,10,0,1,"coding"
"AFF1",60,51,9,0,1,"coding"
"SIAH2",25,23,2,0,1,"coding"
"SGSM2",29,22,7,0,1,"coding"
"UBE3A",51,45,6,0,1,"coding"
"XPO1",58,54,4,0,1,"coding"
"CCDC85B",85,69,16,0,1,"coding"
"CCDC90B",9,7,2,0,1,"coding"
"MED31",29,24,5,0,1,"coding"
"CTSG",19,9,10,0,1,"coding"
"ARRB2",33,18,15,0,1,"coding"
"HRAS",48,24,24,0,1,"coding"
"JAK2",65,29,36,0,1,"coding"
"PLCG1",75,41,34,0,1,"coding"
"ARNT",38,20,18,0,1,"coding"
"EP300",166,142,24,0,1,"coding"
"NCOA1",87,56,31,0,1,"coding"
"NCOA2",56,41,15,0,1,"coding"
"SMARCA4",39,24,15,0,1,"coding"
"PRKAR2A",36,30,6,0,1,"coding"
"AKAP10",27,22,5,0,1,"coding"
"PRKAR1A",48,30,18,0,1,"coding"
"GSK3B",118,75,43,0,1,"coding"
"YWHAB",91,66,25,0,1,"coding"
"IQGAP1",37,28,9,0,1,"coding"
"KPNB1",70,56,14,0,1,"coding"
"PRPF40A",60,44,16,0,1,"coding"
"AKAP9",36,32,4,0,1,"coding"
"AKT1",69,37,32,0,1,"coding"
"CHUK",47,31,16,0,1,"coding"
"HTT",56,41,15,0,1,"coding"
"MDM2",93,81,12,0,1,"coding"
"PTEN",72,67,5,0,1,"coding"
"RPS6KB1",30,24,6,0,1,"coding"
"BCL2A1",6,4,2,0,1,"coding"
"HSP90AA1",94,65,29,0,1,"coding"
"IGSF21",12,8,4,0,1,"coding"
"XRN1",37,31,6,0,1,"coding"
"JAK3",31,13,18,0,1,"coding"
"PTN",48,16,32,0,1,"coding"
"CRMP1",45,18,27,0,1,"coding"
"EGFR",140,84,56,0,1,"coding"
"AMOTL2",41,39,2,0,1,"coding"
"MAPK6",103,70,33,0,1,"coding"
"TEK",19,9,10,0,1,"coding"
"NFASC",12,9,3,0,1,"coding"
"ANK3",18,16,2,0,1,"coding"
"HDAC4",44,40,4,0,1,"coding"
"LRP2",28,14,14,0,1,"coding"
"SET",52,46,6,0,1,"coding"
"ANXA1",17,9,8,0,1,"coding"
"C14orf1",32,24,8,0,1,"coding"
"COPS6",59,38,21,0,1,"coding"
"TGM2",24,13,11,0,1,"coding"
"UNC119",62,31,31,0,1,"coding"
"ANXA11",23,21,2,0,1,"coding"
"EED",24,22,2,0,1,"coding"
"CDK4",78,65,13,0,1,"coding"
"AP1G1",38,36,2,0,1,"coding"
"DVL2",21,10,11,0,1,"coding"
"AP2A1",25,18,7,0,1,"coding"
"AP2M1",26,22,4,0,1,"coding"
"MEGF10",7,5,2,0,1,"coding"
"AP3B1",32,28,4,0,1,"coding"
"ARF1",37,26,11,0,1,"coding"
"CLTC",79,63,16,0,1,"coding"
"XPOT",45,42,3,0,1,"coding"
"TGOLN2",48,44,4,0,1,"coding"
"CASP3",93,48,45,0,1,"coding"
"HSPA1A",42,29,13,0,1,"coding"
"APP",70,43,27,0,1,"coding"
"KCNJ12",23,21,2,0,1,"coding"
"APLP2",15,14,1,0,1,"coding"
"SIAH1",19,17,2,0,1,"coding"
"HDAC1",63,52,11,0,1,"coding"
"PCNA",80,69,11,0,1,"coding"
"UBE2I",82,68,14,0,1,"coding"
"LNX1",26,14,12,0,1,"coding"
"NACA",9,8,1,0,1,"coding"
"SETDB1",59,47,12,0,1,"coding"
"APOA1",10,3,7,0,1,"coding"
"TTR",9,6,3,0,1,"coding"
"HSP90B1",47,43,4,0,1,"coding"
"KPNA2",64,59,5,0,1,"coding"
"LRP1",55,39,16,0,1,"coding"
"COL4A2",30,24,6,0,1,"coding"
"FLOT1",19,17,2,0,1,"coding"
"HSPG2",34,28,6,0,1,"coding"
"NID1",41,38,3,0,1,"coding"
"PSEN2",16,8,8,0,1,"coding"
"SHC1",73,46,27,0,1,"coding"
"SNCA",30,15,15,0,1,"coding"
"APPBP2",30,28,2,0,1,"coding"
"PIK3CA",39,29,10,0,1,"coding"
"APTX",19,16,3,0,1,"coding"
"EFEMP2",24,16,8,0,1,"coding"
"CDC37",43,36,7,0,1,"coding"
"CDK7",14,12,2,0,1,"coding"
"CREBBP",232,83,149,0,1,"coding"
"FOXO1",191,45,146,0,1,"coding"
"GTF2F2",14,10,4,0,1,"coding"
"GTF2H1",22,15,7,0,1,"coding"
"KAT2B",54,47,7,0,1,"coding"
"MED1",38,33,5,0,1,"coding"
"NCOA3",59,47,12,0,1,"coding"
"NCOR1",70,35,35,0,1,"coding"
"NCOR2",81,49,32,0,1,"coding"
"NFKB1",122,32,90,0,1,"coding"
"PQBP1",10,8,2,0,1,"coding"
"RNF4",28,27,1,0,1,"coding"
"SMAD1",102,23,79,0,1,"coding"
"SMAD3",145,45,100,0,1,"coding"
"TRIM24",32,24,8,0,1,"coding"
"ARIH2",21,19,2,0,1,"coding"
"ARPC3",12,9,3,0,1,"coding"
"PICK1",19,6,13,0,1,"coding"
"ARF6",15,6,9,0,1,"coding"
"ITPR1",40,30,10,0,1,"coding"
"PIK3R1",145,87,58,0,1,"coding"
"PTPN11",80,40,40,0,1,"coding"
"RASA1",70,44,26,0,1,"coding"
"RHOA",53,31,22,0,1,"coding"
"TUBA4A",24,12,12,0,1,"coding"
"WAS",27,14,13,0,1,"coding"
"RAC1",54,28,26,0,1,"coding"
"SMURF2",52,34,18,0,1,"coding"
"RBPMS",38,34,4,0,1,"coding"
"EZR",16,12,4,0,1,"coding"
"VAV1",42,29,13,0,1,"coding"
"ARHGEF11",9,5,4,0,1,"coding"
"GNA12",31,21,10,0,1,"coding"
"GNA13",48,34,14,0,1,"coding"
"ARHGEF12",41,35,6,0,1,"coding"
"CD44",27,12,15,0,1,"coding"
"IGF1R",119,101,18,0,1,"coding"
"ARHGEF7",19,12,7,0,1,"coding"
"CBLB",38,28,10,0,1,"coding"
"SMARCE1",15,10,5,0,1,"coding"
"E2F1",384,44,340,0,1,"coding"
"E2F2",78,64,14,0,1,"coding"
"HDAC2",50,44,6,0,1,"coding"
"SIN3A",57,51,6,0,1,"coding"
"UBE2L3",19,15,4,0,1,"coding"
"ARL15",19,13,6,0,1,"coding"
"GAPDH",69,48,21,0,1,"coding"
"RPL8",14,11,3,0,1,"coding"
"UBR1",32,19,13,0,1,"coding"
"TLE1",25,22,3,0,1,"coding"
"ATP5J2",13,10,3,0,1,"coding"
"PRMT1",30,18,12,0,1,"coding"
"RNF130",8,6,2,0,1,"coding"
"CSNK2A2",38,29,9,0,1,"coding"
"FLNA",69,51,18,0,1,"coding"
"HIPK3",65,59,6,0,1,"coding"
"MAPK1",133,103,30,0,1,"coding"
"MED8",34,28,6,0,1,"coding"
"HCK",51,34,17,0,1,"coding"
"SH3KBP1",47,42,5,0,1,"coding"
"SNRPB",36,33,3,0,1,"coding"
"MEF2A",37,23,14,0,1,"coding"
"ASF1A",26,25,1,0,1,"coding"
"H3F3A",12,11,1,0,1,"coding"
"ASGR1",14,11,3,0,1,"coding"
"ASIP",3,2,1,0,1,"coding"
"F11R",20,15,5,0,1,"coding"
"CREB1",182,52,130,0,1,"coding"
"GABPB1",43,37,6,0,1,"coding"
"SPI1",149,20,129,0,1,"coding"
"HIST2H2BE",16,13,3,0,1,"coding"
"HMGA1",61,51,10,0,1,"coding"
"BATF3",6,5,1,0,1,"coding"
"CEBPG",27,22,5,0,1,"coding"
"DDIT3",16,8,8,0,1,"coding"
"CDC34",17,16,1,0,1,"coding"
"POLR2D",48,45,3,0,1,"coding"
"TOPBP1",19,15,4,0,1,"coding"
"WRN",15,12,3,0,1,"coding"
"XRCC5",35,28,7,0,1,"coding"
"ATN1",55,31,24,0,1,"coding"
"EWSR1",51,25,26,0,1,"coding"
"TRIP6",25,17,8,0,1,"coding"
"BCL2",80,63,17,0,1,"coding"
"CSE1L",44,42,2,0,1,"coding"
"ATP5C1",23,19,4,0,1,"coding"
"PSME3",33,27,6,0,1,"coding"
"RPP14",20,18,2,0,1,"coding"
"ATR",15,9,6,0,1,"coding"
"EZH2",200,27,173,0,1,"coding"
"ZNF512B",43,33,10,0,1,"coding"
"DAZAP2",70,61,9,0,1,"coding"
"PSMC3",10,6,4,0,1,"coding"
"RAD23A",21,15,6,0,1,"coding"
"RNF11",73,53,20,0,1,"coding"
"NME1",21,16,5,0,1,"coding"
"PPP1CA",34,28,6,0,1,"coding"
"PPP1CC",36,33,3,0,1,"coding"
"GNAS",32,28,4,0,1,"coding"
"AXIN1",35,16,19,0,1,"coding"
"DAB2",46,38,8,0,1,"coding"
"DVL1",18,12,6,0,1,"coding"
"DVL3",33,29,4,0,1,"coding"
"JUP",24,18,6,0,1,"coding"
"PPP2CA",65,54,11,0,1,"coding"
"SH3GL1",25,17,8,0,1,"coding"
"UTP14A",21,15,6,0,1,"coding"
"AXL",42,29,13,0,1,"coding"
"CBL",94,61,33,0,1,"coding"
"IL2RG",13,8,5,0,1,"coding"
"PIK3R2",24,16,8,0,1,"coding"
"PIK3R3",26,21,5,0,1,"coding"
"B2M",23,20,3,0,1,"coding"
"HLA-A",21,14,7,0,1,"coding"
"PRSS23",24,18,6,0,1,"coding"
"PLSCR1",35,17,18,0,1,"coding"
"PSEN1",42,24,18,0,1,"coding"
"MAFK",111,29,82,0,1,"coding"
"MAPK8",58,51,7,0,1,"coding"
"PIM1",23,19,4,0,1,"coding"
"YWHAQ",76,62,14,0,1,"coding"
"KRTAP4-12",5,2,3,0,1,"coding"
"PHYHIP",34,25,9,0,1,"coding"
"SHANK1",13,3,10,0,1,"coding"
"STARD13",38,34,4,0,1,"coding"
"BAIAP2",15,10,5,0,1,"coding"
"NCKIPSD",26,23,3,0,1,"coding"
"BRD7",29,25,4,0,1,"coding"
"IKBKAP",21,18,3,0,1,"coding"
"CREB3L3",4,2,2,0,1,"coding"
"BID",40,32,8,0,1,"coding"
"MAP3K7",41,32,9,0,1,"coding"
"CASP1",21,10,11,0,1,"coding"
"CASP8",41,20,21,0,1,"coding"
"CD2AP",49,45,4,0,1,"coding"
"FAM46A",14,12,2,0,1,"coding"
"CDK2",85,76,9,0,1,"coding"
"CYCS",55,54,1,0,1,"coding"
"HRK",31,30,1,0,1,"coding"
"SF1",22,19,3,0,1,"coding"
"BCL3",27,10,17,0,1,"coding"
"NFKB2",40,12,28,0,1,"coding"
"IRF4",54,27,27,0,1,"coding"
"ERCC3",14,10,4,0,1,"coding"
"RBL1",50,46,4,0,1,"coding"
"BMP4",9,5,4,0,1,"coding"
"NEK9",56,55,1,0,1,"coding"
"DNM2",33,24,9,0,1,"coding"
"BIRC2",25,11,14,0,1,"coding"
"CASP7",24,19,5,0,1,"coding"
"DIABLO",20,16,4,0,1,"coding"
"UBB",38,23,15,0,1,"coding"
"BLK",5,2,3,0,1,"coding"
"FCGR2B",6,2,4,0,1,"coding"
"BLNK",19,12,7,0,1,"coding"
"NAP1L4",17,15,2,0,1,"coding"
"BMI1",31,28,3,0,1,"coding"
"CBX8",25,22,3,0,1,"coding"
"RING1",15,12,3,0,1,"coding"
"RNF2",22,18,4,0,1,"coding"
"COL7A1",15,12,3,0,1,"coding"
"BMP2",36,31,5,0,1,"coding"
"BMPR2",76,63,13,0,1,"coding"
"GDF9",16,4,12,0,1,"coding"
"STUB1",18,5,13,0,1,"coding"
"TUBB",68,55,13,0,1,"coding"
"PTK2",73,40,33,0,1,"coding"
"BNIP3L",34,29,5,0,1,"coding"
"ROBO2",29,21,8,0,1,"coding"
"BRCA2",16,12,4,0,1,"coding"
"CTBP2",19,17,2,0,1,"coding"
"NFYA",115,32,83,0,1,"coding"
"NMI",15,14,1,0,1,"coding"
"RFC1",21,18,3,0,1,"coding"
"BTBD2",23,21,2,0,1,"coding"
"HIST4H4",12,10,2,0,1,"coding"
"RBL2",42,36,6,0,1,"coding"
"PDLIM7",18,13,5,0,1,"coding"
"TRIM5",9,8,1,0,1,"coding"
"BTK",52,8,44,0,1,"coding"
"KHDRBS1",36,30,6,0,1,"coding"
"KIT",55,26,29,0,1,"coding"
"LYN",99,56,43,0,1,"coding"
"MYD88",26,18,8,0,1,"coding"
"PLCG2",61,43,18,0,1,"coding"
"PRKCQ",15,8,7,0,1,"coding"
"SYK",56,20,36,0,1,"coding"
"TNFRSF14",21,12,9,0,1,"coding"
"BTRC",54,41,13,0,1,"coding"
"SKP1",37,32,5,0,1,"coding"
"WEE1",27,21,6,0,1,"coding"
"BUB1",31,26,5,0,1,"coding"
"PLK1",57,34,23,0,1,"coding"
"BUB1B",10,8,2,0,1,"coding"
"C11orf58",23,17,6,0,1,"coding"
"KIAA1377",55,22,33,0,1,"coding"
"RPLP1",35,27,8,0,1,"coding"
"SF3B1",24,19,5,0,1,"coding"
"POLR2C",17,14,3,0,1,"coding"
"TSNAX",11,9,2,0,1,"coding"
"C1QBP",23,19,4,0,1,"coding"
"DCN",24,14,10,0,1,"coding"
"UBQLN4",69,37,32,0,1,"coding"
"C5",5,3,2,0,1,"coding"
"C6",6,5,1,0,1,"coding"
"FGFR3",24,13,11,0,1,"coding"
"C7orf25",13,9,4,0,1,"coding"
"C8orf33",34,29,5,0,1,"coding"
"FEZ1",26,8,18,0,1,"coding"
"IMMT",30,15,15,0,1,"coding"
"CA2",5,4,1,0,1,"coding"
"CCNE1",38,32,6,0,1,"coding"
"CACHD1",16,14,2,0,1,"coding"
"XAB2",8,3,5,0,1,"coding"
"RIMS1",6,3,3,0,1,"coding"
"CACNA1C",52,51,1,0,1,"coding"
"REM1",4,2,2,0,1,"coding"
"MPP3",8,7,1,0,1,"coding"
"CALCOCO2",32,24,8,0,1,"coding"
"DAXX",26,20,6,0,1,"coding"
"GABARAPL2",9,8,1,0,1,"coding"
"GPRASP2",20,8,12,0,1,"coding"
"LYST",21,18,3,0,1,"coding"
"TTN",12,5,7,0,1,"coding"
"CALR",63,46,17,0,1,"coding"
"THBS1",83,71,12,0,1,"coding"
"TRAF6",58,24,34,0,1,"coding"
"CAMK1",5,2,3,0,1,"coding"
"KRT18",31,20,11,0,1,"coding"
"CAMLG",20,16,4,0,1,"coding"
"KCNA3",6,4,2,0,1,"coding"
"LBP",5,4,1,0,1,"coding"
"CANX",56,46,10,0,1,"coding"
"EBI3",11,10,1,0,1,"coding"
"CAPNS1",14,9,5,0,1,"coding"
"CAPRIN1",32,31,1,0,1,"coding"
"TRAF1",57,39,18,0,1,"coding"
"TSC22D1",35,31,4,0,1,"coding"
"CASK",34,16,18,0,1,"coding"
"CNTNAP2",12,9,3,0,1,"coding"
"PRKD2",22,18,4,0,1,"coding"
"PLA2G4A",28,19,9,0,1,"coding"
"DSP",15,14,1,0,1,"coding"
"EEF1A1",71,45,26,0,1,"coding"
"EIF2AK2",53,38,15,0,1,"coding"
"PTMA",46,28,18,0,1,"coding"
"STK4",42,41,1,0,1,"coding"
"TOP1",24,22,2,0,1,"coding"
"CASP4",14,6,8,0,1,"coding"
"CLSPN",35,34,1,0,1,"coding"
"RIPK1",15,10,5,0,1,"coding"
"RYBP",60,57,3,0,1,"coding"
"RNF19A",22,14,8,0,1,"coding"
"SUMO4",12,5,7,0,1,"coding"
"ILK",32,23,9,0,1,"coding"
"IRS1",64,47,17,0,1,"coding"
"PTPRF",27,22,5,0,1,"coding"
"DNAJA1",38,32,6,0,1,"coding"
"CD5",18,14,4,0,1,"coding"
"ITCH",23,19,4,0,1,"coding"
"CBX2",49,48,1,0,1,"coding"
"TAF4",30,22,8,0,1,"coding"
"TRIM28",25,23,2,0,1,"coding"
"MCM10",32,22,10,0,1,"coding"
"CCR5",28,18,10,0,1,"coding"
"MMP3",14,10,4,0,1,"coding"
"CCR1",9,7,2,0,1,"coding"
"VCAN",64,52,12,0,1,"coding"
"DPP4",17,9,8,0,1,"coding"
"CCR3",13,5,8,0,1,"coding"
"IL8",11,10,1,0,1,"coding"
"CCL5",22,14,8,0,1,"coding"
"SDC1",19,13,6,0,1,"coding"
"MMP14",33,21,12,0,1,"coding"
"CCNB1",75,61,14,0,1,"coding"
"CDC25C",14,9,5,0,1,"coding"
"GADD45G",34,21,13,0,1,"coding"
"CDK9",31,21,10,0,1,"coding"
"JAK1",73,45,28,0,1,"coding"
"CD4",45,27,18,0,1,"coding"
"PTK2B",50,24,26,0,1,"coding"
"TXK",15,11,4,0,1,"coding"
"PAFAH1B2",47,45,2,0,1,"coding"
"VHL",26,20,6,0,1,"coding"
"ITGB2",32,10,22,0,1,"coding"
"ITGB1",80,48,32,0,1,"coding"
"PTPRC",32,19,13,0,1,"coding"
"CD2",14,8,6,0,1,"coding"
"CD244",7,5,2,0,1,"coding"
"LAT",21,9,12,0,1,"coding"
"CD247",21,5,16,0,1,"coding"
"CSK",29,21,8,0,1,"coding"
"SIVA1",12,10,2,0,1,"coding"
"TRAF2",87,17,70,0,1,"coding"
"TRAF3",19,14,5,0,1,"coding"
"CD28",29,16,13,0,1,"coding"
"GRAP2",45,31,14,0,1,"coding"
"PKD2",26,24,2,0,1,"coding"
"CD3E",16,10,6,0,1,"coding"
"IL16",21,16,5,0,1,"coding"
"GNAI1",48,27,21,0,1,"coding"
"ITGAV",37,27,10,0,1,"coding"
"UBQLN1",33,25,8,0,1,"coding"
"CD48",11,7,4,0,1,"coding"
"IL2",9,7,2,0,1,"coding"
"SDCBP",39,32,7,0,1,"coding"
"HLA-DRA",14,11,3,0,1,"coding"
"CD81",21,16,5,0,1,"coding"
"ITGA4",19,14,5,0,1,"coding"
"HBEGF",30,24,6,0,1,"coding"
"CD8A",12,5,7,0,1,"coding"
"COL4A1",32,26,6,0,1,"coding"
"COL4A3",20,13,7,0,1,"coding"
"MELK",44,43,1,0,1,"coding"
"SAFB",20,14,6,0,1,"coding"
"ITSN1",51,43,8,0,1,"coding"
"CDH2",34,27,7,0,1,"coding"
"GRIN2D",26,17,9,0,1,"coding"
"PKP4",20,19,1,0,1,"coding"
"CDK5RAP1",6,4,2,0,1,"coding"
"CDKN1B",28,19,9,0,1,"coding"
"PAX6",14,9,5,0,1,"coding"
"GATA2",108,12,96,0,1,"coding"
"MYB",148,20,128,0,1,"coding"
"SMARCC1",28,20,8,0,1,"coding"
"TAF9",24,17,7,0,1,"coding"
"FOSL2",130,65,65,0,1,"coding"
"TP53",63,12,51,0,1,"coding"
"SPTBN4",24,19,5,0,1,"coding"
"PIN1",54,36,18,0,1,"coding"
"SNAP25",16,14,2,0,1,"coding"
"NEK2",12,7,5,0,1,"coding"
"CHEK2",41,28,13,0,1,"coding"
"CHFR",14,10,4,0,1,"coding"
"CHGB",9,4,5,0,1,"coding"
"POLR2E",22,18,4,0,1,"coding"
"CHM",9,8,1,0,1,"coding"
"CHMP1B",15,13,2,0,1,"coding"
"CHMP2A",8,6,2,0,1,"coding"
"MAPK8IP2",32,20,12,0,1,"coding"
"GNA15",5,3,2,0,1,"coding"
"WWP1",29,25,4,0,1,"coding"
"GADD45A",35,23,12,0,1,"coding"
"ICAM3",6,4,2,0,1,"coding"
"TYROBP",8,6,2,0,1,"coding"
"GOLM1",19,17,2,0,1,"coding"
"HGS",37,20,17,0,1,"coding"
"CMA1",5,2,3,0,1,"coding"
"CNKSR1",7,5,2,0,1,"coding"
"CNKSR2",23,20,3,0,1,"coding"
"CNOT7",15,12,3,0,1,"coding"
"MET",57,38,19,0,1,"coding"
"LIFR",44,40,4,0,1,"coding"
"HN1L",12,11,1,0,1,"coding"
"CNTN1",19,16,3,0,1,"coding"
"PTPRB",33,29,4,0,1,"coding"
"RTN4",23,13,10,0,1,"coding"
"KCNA2",10,8,2,0,1,"coding"
"COG4",3,2,1,0,1,"coding"
"MAD1L1",9,7,2,0,1,"coding"
"COL13A1",25,20,5,0,1,"coding"
"PPL",20,18,2,0,1,"coding"
"KDR",51,29,22,0,1,"coding"
"IGFBP3",35,27,8,0,1,"coding"
"COL2A1",20,12,8,0,1,"coding"
"PXN",55,30,25,0,1,"coding"
"XRN2",14,9,5,0,1,"coding"
"MAPK14",60,48,12,0,1,"coding"
"TRIM37",40,32,8,0,1,"coding"
"COPS3",11,6,5,0,1,"coding"
"COPS5",17,15,2,0,1,"coding"
"GPS1",19,13,6,0,1,"coding"
"CPE",32,27,5,0,1,"coding"
"RPA1",19,6,13,0,1,"coding"
"NUDT21",33,23,10,0,1,"coding"
"GLI2",44,31,13,0,1,"coding"
"NFIL3",18,17,1,0,1,"coding"
"DACH1",30,24,6,0,1,"coding"
"EBF1",167,31,136,0,1,"coding"
"ETS1",202,60,142,0,1,"coding"
"GATA1",220,7,213,0,1,"coding"
"MAFG",18,14,4,0,1,"coding"
"NCOA6",33,26,7,0,1,"coding"
"NFIC",101,43,58,0,1,"coding"
"PROX1",44,37,7,0,1,"coding"
"SNIP1",38,33,5,0,1,"coding"
"TUBB2A",31,29,2,0,1,"coding"
"FRS2",82,75,7,0,1,"coding"
"IRS2",37,30,7,0,1,"coding"
"CRKL",62,42,20,0,1,"coding"
"GAB2",13,8,5,0,1,"coding"
"TGFB1I1",23,22,1,0,1,"coding"
"PPP1R8",17,10,7,0,1,"coding"
"CSF1",26,23,3,0,1,"coding"
"INPP5D",19,9,10,0,1,"coding"
"FES",12,8,4,0,1,"coding"
"HNRNPK",38,28,10,0,1,"coding"
"HDAC3",24,19,5,0,1,"coding"
"ERCC8",8,6,2,0,1,"coding"
"POLR2B",16,15,1,0,1,"coding"
"SNRNP70",19,14,5,0,1,"coding"
"CTGF",43,41,2,0,1,"coding"
"NOV",15,10,5,0,1,"coding"
"RUVBL1",11,10,1,0,1,"coding"
"ZFYVE9",25,19,6,0,1,"coding"
"FAM118B",13,12,1,0,1,"coding"
"LGALS3",16,12,4,0,1,"coding"
"NCF4",6,5,1,0,1,"coding"
"FMR1",26,23,3,0,1,"coding"
"FXR2",33,22,11,0,1,"coding"
"TRIM23",30,24,6,0,1,"coding"
"DAG1",26,19,7,0,1,"coding"
"MCM7",49,38,11,0,1,"coding"
"UPF1",16,11,5,0,1,"coding"
"RPGR",5,4,1,0,1,"coding"
"NIF3L1",29,23,6,0,1,"coding"
"SNAPIN",15,10,5,0,1,"coding"
"EIF3E",20,16,4,0,1,"coding"
"NUP62",20,19,1,0,1,"coding"
"DEK",31,29,2,0,1,"coding"
"SRRM1",7,3,4,0,1,"coding"
"MYO15A",2,1,1,0,1,"coding"
"HSPD1",40,33,7,0,1,"coding"
"PTCH1",19,18,1,0,1,"coding"
"DIAPH2",26,25,1,0,1,"coding"
"DLEU1",9,6,3,0,1,"coding"
"PSMA1",18,9,9,0,1,"coding"
"DLG1",43,11,32,0,1,"coding"
"GNG13",3,2,1,0,1,"coding"
"MAPK12",13,4,9,0,1,"coding"
"DLG2",48,27,21,0,1,"coding"
"DLGAP1",11,5,6,0,1,"coding"
"NOS1",19,11,8,0,1,"coding"
"DLG3",35,16,19,0,1,"coding"
"SYNGAP1",26,24,2,0,1,"coding"
"YES1",39,32,7,0,1,"coding"
"DLST",9,7,2,0,1,"coding"
"DYNLL2",47,45,2,0,1,"coding"
"DLGAP4",14,11,3,0,1,"coding"
"FLII",13,10,3,0,1,"coding"
"SOX10",21,9,12,0,1,"coding"
"SOX8",16,11,5,0,1,"coding"
"NUDT3",50,36,14,0,1,"coding"
"DNAJC3",26,23,3,0,1,"coding"
"HSPA1B",22,21,1,0,1,"coding"
"DNMBP",21,18,3,0,1,"coding"
"TRIM27",19,17,2,0,1,"coding"
"KIAA1279",23,19,4,0,1,"coding"
"DPM2",13,12,1,0,1,"coding"
"DPPA2",5,2,3,0,1,"coding"
"SH3GL3",17,4,13,0,1,"coding"
"MPDZ",15,9,6,0,1,"coding"
"GABRA1",5,3,2,0,1,"coding"
"NCK1",53,15,38,0,1,"coding"
"KRT5",6,3,3,0,1,"coding"
"MAPK11",9,7,2,0,1,"coding"
"DUSP23",13,7,6,0,1,"coding"
"PRPF3",4,2,2,0,1,"coding"
"DYNC1I1",16,11,5,0,1,"coding"
"PNN",13,8,5,0,1,"coding"
"PARD3",17,10,7,0,1,"coding"
"E2F6",200,26,174,0,1,"coding"
"TFDP1",19,15,4,0,1,"coding"
"TFDP2",37,33,4,0,1,"coding"
"E2F3",134,73,61,0,1,"coding"
"ECH1",10,6,4,0,1,"coding"
"RHOG",17,14,3,0,1,"coding"
"EDA",6,5,1,0,1,"coding"
"GRK6",20,16,4,0,1,"coding"
"EXOSC4",19,9,10,0,1,"coding"
"EEF1B2",6,4,2,0,1,"coding"
"MVD",4,3,1,0,1,"coding"
"EEF2K",25,19,6,0,1,"coding"
"EFNA1",22,19,3,0,1,"coding"
"EFNA3",14,13,1,0,1,"coding"
"EFNA5",37,36,1,0,1,"coding"
"EPHB2",34,20,14,0,1,"coding"
"EFNB1",25,20,5,0,1,"coding"
"PTPN13",19,14,5,0,1,"coding"
"RGS3",16,12,4,0,1,"coding"
"HOMER1",28,19,9,0,1,"coding"
"SNRPD2",18,9,9,0,1,"coding"
"NPM1",26,18,8,0,1,"coding"
"EIF3F",11,8,3,0,1,"coding"
"EIF4E",20,18,2,0,1,"coding"
"GNB2L1",36,29,7,0,1,"coding"
"ID2",20,13,7,0,1,"coding"
"ELN",21,19,2,0,1,"coding"
"FYB",15,5,10,0,1,"coding"
"TES",35,30,5,0,1,"coding"
"ING4",8,6,2,0,1,"coding"
"EPHB3",9,6,3,0,1,"coding"
"GRAP",11,8,3,0,1,"coding"
"SYNCRIP",66,64,2,0,1,"coding"
"HOOK2",9,7,2,0,1,"coding"
"FLI1",260,26,234,0,1,"coding"
"SMARCA2",23,20,3,0,1,"coding"
"ETF1",15,14,1,0,1,"coding"
"MAF",62,38,24,0,1,"coding"
"RAB27A",30,21,9,0,1,"coding"
"F10",14,9,5,0,1,"coding"
"SGTA",13,8,5,0,1,"coding"
"TJP1",47,36,11,0,1,"coding"
"PROC",5,4,1,0,1,"coding"
"SERPINC1",12,10,2,0,1,"coding"
"F2R",35,26,9,0,1,"coding"
"PRTN3",6,5,1,0,1,"coding"
"F2RL2",21,18,3,0,1,"coding"
"RAP1A",36,22,14,0,1,"coding"
"RABAC1",38,25,13,0,1,"coding"
"TNFRSF1A",40,18,22,0,1,"coding"
"HDAC6",12,10,2,0,1,"coding"
"FCER1G",10,4,6,0,1,"coding"
"ZAP70",34,4,30,0,1,"coding"
"MEST",7,5,2,0,1,"coding"
"FGFR1",38,31,7,0,1,"coding"
"HSPA9",25,22,3,0,1,"coding"
"SYT1",27,23,4,0,1,"coding"
"RPS6KA3",81,70,11,0,1,"coding"
"HNRNPL",33,28,5,0,1,"coding"
"ICAM1",21,18,3,0,1,"coding"
"FIGF",5,3,2,0,1,"coding"
"FLNB",26,23,3,0,1,"coding"
"NPHP1",11,9,2,0,1,"coding"
"SHBG",5,1,4,0,1,"coding"
"SYNJ1",24,16,8,0,1,"coding"
"FOXA2",44,1,43,0,1,"coding"
"NR1H3",27,10,17,0,1,"coding"
"MPHOSPH6",13,9,4,0,1,"coding"
"TAF10",20,9,11,0,1,"coding"
"SLC35E1",11,9,2,0,1,"coding"
"PRKCH",16,14,2,0,1,"coding"
"GIPC1",26,18,8,0,1,"coding"
"WNT1",19,16,3,0,1,"coding"
"MAP3K3",52,48,4,0,1,"coding"
"GABARAP",14,7,7,0,1,"coding"
"PPP3CA",24,15,9,0,1,"coding"
"PRKCG",12,3,9,0,1,"coding"
"GABRB2",25,23,2,0,1,"coding"
"TRAK2",25,23,2,0,1,"coding"
"GAL",10,9,1,0,1,"coding"
"GNAQ",51,35,16,0,1,"coding"
"GAP43",18,17,1,0,1,"coding"
"IARS",15,14,1,0,1,"coding"
"GAS1",28,26,2,0,1,"coding"
"NR5A1",7,3,4,0,1,"coding"
"MBD3",186,28,158,0,1,"coding"
"GBP2",15,7,8,0,1,"coding"
"GDE1",40,39,1,0,1,"coding"
"S100A8",17,14,3,0,1,"coding"
"NCAM1",20,15,5,0,1,"coding"
"RET",25,10,15,0,1,"coding"
"GGA1",27,21,6,0,1,"coding"
"GGA2",33,23,10,0,1,"coding"
"RABEP1",33,30,3,0,1,"coding"
"GGA3",18,15,3,0,1,"coding"
"TSG101",23,15,8,0,1,"coding"
"GHRL",3,1,2,0,1,"coding"
"RGS19",19,11,8,0,1,"coding"
"NUDT18",18,12,6,0,1,"coding"
"PLEKHF2",36,34,2,0,1,"coding"
"GMEB1",16,10,6,0,1,"coding"
"TRPC3",21,14,7,0,1,"coding"
"TSHR",12,4,8,0,1,"coding"
"GPSM2",21,18,3,0,1,"coding"
"GNAI3",26,16,10,0,1,"coding"
"PLCB1",24,19,5,0,1,"coding"
"GOLGA2",29,19,10,0,1,"coding"
"IGF2",55,49,6,0,1,"coding"
"LRSAM1",14,8,6,0,1,"coding"
"SHB",15,12,3,0,1,"coding"
"GRASP",8,5,3,0,1,"coding"
"NGFR",44,25,19,0,1,"coding"
"USP8",21,19,2,0,1,"coding"
"VAV3",67,58,9,0,1,"coding"
"PPM1A",44,38,6,0,1,"coding"
"TUBA1B",36,34,2,0,1,"coding"
"SGK1",47,43,4,0,1,"coding"
"TAF1C",12,9,3,0,1,"coding"
"HAND2",52,24,28,0,1,"coding"
"HEY2",13,12,1,0,1,"coding"
"HEYL",43,39,4,0,1,"coding"
"TCF3",172,21,151,0,1,"coding"
"MMP2",56,35,21,0,1,"coding"
"PSMD4",11,9,2,0,1,"coding"
"SPOP",23,21,2,0,1,"coding"
"NR4A1",26,8,18,0,1,"coding"
"HEXDC",7,4,3,0,1,"coding"
"SMAD7",45,33,12,0,1,"coding"
"PLAU",16,12,4,0,1,"coding"
"HLA-B",14,10,4,0,1,"coding"
"HLA-C",16,8,8,0,1,"coding"
"HSPA5",35,21,14,0,1,"coding"
"MBP",28,7,21,0,1,"coding"
"IRF1",65,16,49,0,1,"coding"
"NR1H2",35,8,27,0,1,"coding"
"SEPT2",4,1,3,0,1,"coding"
"TNPO1",62,58,4,0,1,"coding"
"PKNOX1",20,19,1,0,1,"coding"
"MEIS1",46,37,9,0,1,"coding"
"PBX1",116,34,82,0,1,"coding"
"HOXC8",30,28,2,0,1,"coding"
"TAF1",153,16,137,0,1,"coding"
"NUAK1",44,36,8,0,1,"coding"
"S1PR1",56,53,3,0,1,"coding"
"HTRA1",18,9,9,0,1,"coding"
"ICAM4",4,3,1,0,1,"coding"
"IFNAR1",26,18,8,0,1,"coding"
"TYK2",15,8,7,0,1,"coding"
"IFNAR2",46,42,4,0,1,"coding"
"IGBP1",13,11,2,0,1,"coding"
"IGF1",86,84,2,0,1,"coding"
"IGFBP5",38,33,5,0,1,"coding"
"RANBP10",8,7,1,0,1,"coding"
"IKZF1",33,11,22,0,1,"coding"
"IKZF4",19,17,2,0,1,"coding"
"IKZF5",35,33,2,0,1,"coding"
"IL12B",5,4,1,0,1,"coding"
"IL4R",18,8,10,0,1,"coding"
"IL2RB",19,6,13,0,1,"coding"
"IL18",7,4,3,0,1,"coding"
"IL1RAP",35,27,8,0,1,"coding"
"NDN",21,16,5,0,1,"coding"
"TICAM2",10,4,6,0,1,"coding"
"IL21",2,1,1,0,1,"coding"
"PTPN6",60,12,48,0,1,"coding"
"IRAK1",52,26,26,0,1,"coding"
"TRAF4",20,13,7,0,1,"coding"
"IRF2",16,11,5,0,1,"coding"
"IRF3",22,13,9,0,1,"coding"
"ITGA2",38,29,9,0,1,"coding"
"ITGB7",10,3,7,0,1,"coding"
"ITGB5",26,13,13,0,1,"coding"
"LTB",9,7,2,0,1,"coding"
"RANBP9",20,16,4,0,1,"coding"
"VTN",11,3,8,0,1,"coding"
"PRKG1",48,34,14,0,1,"coding"
"PPIA",29,25,4,0,1,"coding"
"VTA1",35,31,4,0,1,"coding"
"KHSRP",33,29,4,0,1,"coding"
"ZNF638",31,25,6,0,1,"coding"
"LAIR1",9,8,1,0,1,"coding"
"LAMA2",7,6,1,0,1,"coding"
"LEF1",21,11,10,0,1,"coding"
"LIMS1",31,26,5,0,1,"coding"
"TMPO",39,35,4,0,1,"coding"
"LRP3",16,14,2,0,1,"coding"
"LSM2",9,3,6,0,1,"coding"
"LSM4",19,14,5,0,1,"coding"
"LSM5",14,9,5,0,1,"coding"
"LSM7",15,4,11,0,1,"coding"
"PTCD3",18,17,1,0,1,"coding"
"ZHX1",34,26,8,0,1,"coding"
"MED12",11,9,2,0,1,"coding"
"PDX1",5,2,3,0,1,"coding"
"MAP1B",86,77,9,0,1,"coding"
"MAP2K6",21,19,2,0,1,"coding"
"MAP3K5",36,22,14,0,1,"coding"
"PHC2",19,15,4,0,1,"coding"
"RAI1",18,15,3,0,1,"coding"
"MAPK8IP3",29,16,13,0,1,"coding"
"SNAP23",32,24,8,0,1,"coding"
"TTF2",37,27,10,0,1,"coding"
"MAZ",162,30,132,0,1,"coding"
"SRPK1",39,37,2,0,1,"coding"
"POMC",6,3,3,0,1,"coding"
"MED9",14,10,4,0,1,"coding"
"MEF2D",69,65,4,0,1,"coding"
"MEP1B",2,1,1,0,1,"coding"
"MINK1",40,36,4,0,1,"coding"
"OSGEP",10,2,8,0,1,"coding"
"SYNE1",36,31,5,0,1,"coding"
"MYCN",71,12,59,0,1,"coding"
"ZFHX3",53,52,1,0,1,"coding"
"RAB11A",45,42,3,0,1,"coding"
"PNKP",6,4,2,0,1,"coding"
"NCF2",7,4,3,0,1,"coding"
"RORA",91,86,5,0,1,"coding"
"RORB",50,46,4,0,1,"coding"
"RXRB",26,17,9,0,1,"coding"
"NR1D2",17,15,2,0,1,"coding"
"NR1D1",4,2,2,0,1,"coding"
"SDCBP2",4,2,2,0,1,"coding"
"TLX1",27,11,16,0,1,"coding"
"RELB",15,9,6,0,1,"coding"
"NTRK1",16,3,13,0,1,"coding"
"SMPD1",12,11,1,0,1,"coding"
"NKX2-1",11,3,8,0,1,"coding"
"NLGN3",11,8,3,0,1,"coding"
"SFPQ",124,46,78,0,1,"coding"
"NOP2",16,14,2,0,1,"coding"
"NPPA",4,2,2,0,1,"coding"
"NPR1",42,40,2,0,1,"coding"
"PYY",3,2,1,0,1,"coding"
"NPY2R",4,3,1,0,1,"coding"
"RXRG",8,6,2,0,1,"coding"
"SIX3",14,11,3,0,1,"coding"
"STX4",18,12,6,0,1,"coding"
"NUP98",23,17,6,0,1,"coding"
"RANBP2",45,33,12,0,1,"coding"
"PABPC1",41,31,10,0,1,"coding"
"BACH2",76,65,11,0,1,"coding"
"WT1",16,12,4,0,1,"coding"
"YBX1",29,23,6,0,1,"coding"
"RAD50",10,7,3,0,1,"coding"
"PDGFRB",43,18,25,0,1,"coding"
"PEX5",14,9,5,0,1,"coding"
"PFN2",35,31,4,0,1,"coding"
"SCMH1",6,4,2,0,1,"coding"
"RND1",5,2,3,0,1,"coding"
"POLDIP2",23,19,4,0,1,"coding"
"TAF15",20,16,4,0,1,"coding"
"POLR3F",15,12,3,0,1,"coding"
"PPP1CB",30,29,1,0,1,"coding"
"PRIM1",26,25,1,0,1,"coding"
"XPA",8,5,3,0,1,"coding"
"PRLR",43,31,12,0,1,"coding"
"SNRPD1",67,61,6,0,1,"coding"
"PROS1",5,2,3,0,1,"coding"
"PTGDS",7,4,3,0,1,"coding"
"PTGFR",14,12,2,0,1,"coding"
"PTPRE",15,9,6,0,1,"coding"
"RABGGTB",14,13,1,0,1,"coding"
"RAB3A",7,4,3,0,1,"coding"
"RAB5B",56,52,4,0,1,"coding"
"RDH11",18,16,2,0,1,"coding"
"RFX2",7,5,2,0,1,"coding"
"RFX3",21,19,2,0,1,"coding"
"RINT1",8,6,2,0,1,"coding"
"SMAD5",52,42,10,0,1,"coding"
"SLC9A3",5,3,2,0,1,"coding"
"SIX5",60,17,43,0,1,"coding"
"SOX5",28,26,2,0,1,"coding"
"ZNF76",27,10,17,0,1,"coding"
"TCEB1",39,35,4,0,1,"coding"
"SOX6",38,37,1,0,1,"coding"
"SREBF2",14,8,6,0,1,"coding"
"NKX3-1",21,8,13,0,1,"coding"
"SPOCK2",11,10,1,0,1,"coding"
"STAT4",12,4,8,0,1,"coding"
"TF",9,2,7,0,1,"coding"
"YEATS4",9,8,1,0,1,"coding"
"TFAP2C",109,12,97,0,1,"coding"
"TM4SF1",10,7,3,0,1,"coding"
"TNFSF10",10,9,1,0,1,"coding"
"TNFSF12",4,3,1,0,1,"coding"
"TNFRSF13C",24,22,2,0,1,"coding"
"TNFRSF4",6,1,5,0,1,"coding"
"ZBTB43",24,22,2,0,1,"coding"
"ZNF417",26,24,2,0,1,"coding"
"ZNF165",3,2,1,0,1,"coding"
"ZNF250",9,6,3,0,1,"coding"
"ZNF446",16,14,2,0,1,"coding"
"DPF2",14,13,1,0,1,"coding"
"SP2",44,9,35,0,1,"coding"
"ASH2L",7,5,2,0,1,"coding"
"KLF2",39,36,3,0,1,"coding"
