"Name","K","Kin","Kout","TypeI","TypeII"
"ANXA7",69,49,20,0,1
"A2M",28,11,17,0,1
"ATF7IP",60,38,22,0,1
"CDKN1A",92,74,18,0,1
"H2AFX",40,34,6,0,1
"HMOX2",16,8,8,0,1
"MYOC",19,7,12,0,1
"SMN1",55,26,29,0,1
"TGFBI",15,12,3,0,1
"TK1",105,76,29,0,1
"MAP1LC3B",20,15,5,0,1
"MDFI",50,42,8,0,1
"RB1",133,110,23,0,1
"ABCA1",51,45,6,0,1
"CSNK2A1",120,93,27,0,1
"FADD",24,13,11,0,1
"MPP6",32,27,5,0,1
"HAX1",15,12,3,0,1
"RDX",30,24,6,0,1
"STX1A",24,14,10,0,1
"EPS8",29,21,8,0,1
"HSPA8",60,41,19,0,1
"NCK2",33,21,12,0,1
"SOS1",52,32,20,0,1
"SOS2",21,16,5,0,1
"WASF1",21,17,4,0,1
"KRT15",32,28,4,0,1
"ABL1",79,47,32,0,1
"ATM",43,25,18,0,1
"BCAR1",40,30,10,0,1
"CASP9",29,21,8,0,1
"CAV1",102,66,36,0,1
"CDK5",30,23,7,0,1
"CRK",87,61,26,0,1
"MAPT",49,39,10,0,1
"POLR2A",64,53,11,0,1
"PRKD1",31,24,7,0,1
"PTPN12",30,27,3,0,1
"RAD51",71,65,6,0,1
"RAN",74,61,13,0,1
"XRCC6",49,33,16,0,1
"YWHAE",67,52,15,0,1
"YWHAZ",163,104,59,0,1
"ABL2",41,38,3,0,1
"VIM",101,70,31,0,1
"ATXN1",148,120,28,0,1
"FBLN1",15,10,5,0,1
"FBLN2",21,17,4,0,1
"USP7",36,31,5,0,1
"LAMB1",8,7,1,0,1
"YWHAG",192,149,43,0,1
"CTNNB1",103,80,23,0,1
"FYN",153,84,69,0,1
"INSR",62,30,32,0,1
"LCK",74,39,35,0,1
"SPTAN1",27,16,11,0,1
"CFL1",21,16,5,0,1
"MYLK",66,61,5,0,1
"PFN1",43,31,12,0,1
"PRKCA",132,63,69,0,1
"S100A4",8,5,3,0,1
"VASP",23,19,4,0,1
"VCL",113,80,33,0,1
"ACTB",104,78,26,0,1
"BCL2L1",48,40,8,0,1
"CSNK1A1",73,64,9,0,1
"EMD",21,17,4,0,1
"RCC1",36,29,7,0,1
"ACTN4",28,22,6,0,1
"DMD",46,42,4,0,1
"DYNLL1",38,27,11,0,1
"GSN",28,20,8,0,1
"PDPK1",82,71,11,0,1
"PIP4K2C",28,22,6,0,1
"RPS6KA5",53,48,5,0,1
"ARHGDIA",32,30,2,0,1
"ACTN1",50,38,12,0,1
"COIL",49,42,7,0,1
"MAGEA11",14,8,6,0,1
"PKN1",21,17,4,0,1
"CAMK2A",38,29,9,0,1
"DISC1",25,24,1,0,1
"DCTN1",13,10,3,0,1
"CHD3",55,40,15,0,1
"CDC42",66,38,28,0,1
"CTTN",15,11,4,0,1
"ACVR1",73,51,22,0,1
"AP2B1",46,36,10,0,1
"IKBKB",39,29,10,0,1
"RAP2A",29,23,6,0,1
"STX8",9,8,1,0,1
"ACVR2A",49,47,2,0,1
"SYNJ2BP",37,33,4,0,1
"TGFB1",34,20,14,0,1
"TGFB3",13,10,3,0,1
"TGFBR1",109,68,41,0,1
"TGFBR2",105,89,16,0,1
"GRB2",128,65,63,0,1
"SH3D19",45,43,2,0,1
"TGFA",26,22,4,0,1
"ADAM15",11,10,1,0,1
"MAD2L1",20,16,4,0,1
"NOTCH1",44,38,6,0,1
"TNF",13,11,2,0,1
"TNFSF11",26,15,11,0,1
"RYR1",11,6,5,0,1
"MAD2L2",6,2,4,0,1
"FN1",92,70,22,0,1
"ADCY10",2,1,1,0,1
"RAF1",45,31,14,0,1
"ADCYAP1",14,13,1,0,1
"CALM1",75,53,22,0,1
"PRKCD",51,29,22,0,1
"APPL1",32,25,7,0,1
"GNAZ",8,5,3,0,1
"CYTH2",22,16,6,0,1
"SLC9A3R2",25,19,6,0,1
"RGS2",30,10,20,0,1
"GNA11",20,15,5,0,1
"ADRBK1",33,17,16,0,1
"GNAI2",50,44,6,0,1
"GNAO1",15,6,9,0,1
"DLG4",64,27,37,0,1
"ADRB2",27,15,12,0,1
"ARRB1",46,30,16,0,1
"GPRASP1",29,11,18,0,1
"GRK5",31,22,9,0,1
"SLC9A3R1",36,19,17,0,1
"SRC",79,37,42,0,1
"CAPN2",14,8,6,0,1
"CSNK2B",76,32,44,0,1
"GIT1",48,33,15,0,1
"MAPK3",50,41,9,0,1
"PEBP1",32,30,2,0,1
"PIK3CG",24,19,5,0,1
"CXCR4",26,15,11,0,1
"PRKCB",54,35,19,0,1
"PRKCE",42,30,12,0,1
"PRKCZ",46,22,24,0,1
"ATXN1L",57,47,10,0,1
"AFF1",60,51,9,0,1
"SIAH2",25,23,2,0,1
"SGSM2",29,22,7,0,1
"UBE3A",51,45,6,0,1
"XPO1",58,54,4,0,1
"CCDC85B",85,69,16,0,1
"CCDC90B",9,7,2,0,1
"MED31",29,24,5,0,1
"CTSG",19,9,10,0,1
"ARRB2",33,18,15,0,1
"HRAS",48,24,24,0,1
"JAK2",65,29,36,0,1
"PLCG1",75,41,34,0,1
"ARNT",38,20,18,0,1
"EP300",166,142,24,0,1
"NCOA1",87,56,31,0,1
"NCOA2",56,41,15,0,1
"SMARCA4",39,24,15,0,1
"PRKAR2A",36,30,6,0,1
"AKAP10",27,22,5,0,1
"PRKAR1A",48,30,18,0,1
"GSK3B",118,75,43,0,1
"YWHAB",91,66,25,0,1
"IQGAP1",37,28,9,0,1
"KPNB1",70,56,14,0,1
"PRPF40A",60,44,16,0,1
"AKAP9",36,32,4,0,1
"AKT1",69,37,32,0,1
"CHUK",47,31,16,0,1
"HTT",56,41,15,0,1
"MDM2",93,81,12,0,1
"PTEN",72,67,5,0,1
"RPS6KB1",30,24,6,0,1
"BCL2A1",6,4,2,0,1
"HSP90AA1",94,65,29,0,1
"IGSF21",12,8,4,0,1
"XRN1",37,31,6,0,1
"JAK3",31,13,18,0,1
"PTN",48,16,32,0,1
"CRMP1",45,18,27,0,1
"EGFR",140,84,56,0,1
"AMOTL2",41,39,2,0,1
"MAPK6",103,70,33,0,1
"TEK",19,9,10,0,1
"NFASC",12,9,3,0,1
"ANK3",18,16,2,0,1
"HDAC4",44,40,4,0,1
"LRP2",28,14,14,0,1
"SET",52,46,6,0,1
"ANXA1",17,9,8,0,1
"C14orf1",32,24,8,0,1
"COPS6",59,38,21,0,1
"TGM2",24,13,11,0,1
"UNC119",62,31,31,0,1
"ANXA11",23,21,2,0,1
"EED",24,22,2,0,1
"CDK4",78,65,13,0,1
"AP1G1",38,36,2,0,1
"DVL2",21,10,11,0,1
"AP2A1",25,18,7,0,1
"AP2M1",26,22,4,0,1
"MEGF10",7,5,2,0,1
"AP3B1",32,28,4,0,1
"ARF1",37,26,11,0,1
"CLTC",79,63,16,0,1
"XPOT",45,42,3,0,1
"TGOLN2",48,44,4,0,1
"CASP3",93,48,45,0,1
"HSPA1A",42,29,13,0,1
"APP",70,43,27,0,1
"KCNJ12",23,21,2,0,1
"APLP2",15,14,1,0,1
"SIAH1",19,17,2,0,1
"HDAC1",63,52,11,0,1
"PCNA",80,69,11,0,1
"UBE2I",82,68,14,0,1
"LNX1",26,14,12,0,1
"NACA",9,8,1,0,1
"SETDB1",59,47,12,0,1
"APOA1",10,3,7,0,1
"TTR",9,6,3,0,1
"HSP90B1",47,43,4,0,1
"KPNA2",64,59,5,0,1
"LRP1",55,39,16,0,1
"COL4A2",30,24,6,0,1
"FLOT1",19,17,2,0,1
"HSPG2",34,28,6,0,1
"NID1",41,38,3,0,1
"PSEN2",16,8,8,0,1
"SHC1",73,46,27,0,1
"SNCA",30,15,15,0,1
"APPBP2",30,28,2,0,1
"PIK3CA",39,29,10,0,1
"APTX",19,16,3,0,1
"EFEMP2",24,16,8,0,1
"CDC37",43,36,7,0,1
"CDK7",14,12,2,0,1
"CREBBP",232,83,149,0,1
"FOXO1",191,45,146,0,1
"GTF2F2",14,10,4,0,1
"GTF2H1",22,15,7,0,1
"KAT2B",54,47,7,0,1
"MED1",38,33,5,0,1
"NCOA3",59,47,12,0,1
"NCOR1",70,35,35,0,1
"NCOR2",81,49,32,0,1
"NFKB1",122,32,90,0,1
"PQBP1",10,8,2,0,1
"RNF4",28,27,1,0,1
"SMAD1",102,23,79,0,1
"SMAD3",145,45,100,0,1
"TRIM24",32,24,8,0,1
"ARIH2",21,19,2,0,1
"ARPC3",12,9,3,0,1
"PICK1",19,6,13,0,1
"ARF6",15,6,9,0,1
"ITPR1",40,30,10,0,1
"PIK3R1",145,87,58,0,1
"PTPN11",80,40,40,0,1
"RASA1",70,44,26,0,1
"RHOA",53,31,22,0,1
"TUBA4A",24,12,12,0,1
"WAS",27,14,13,0,1
"RAC1",54,28,26,0,1
"SMURF2",52,34,18,0,1
"RBPMS",38,34,4,0,1
"EZR",16,12,4,0,1
"VAV1",42,29,13,0,1
"ARHGEF11",9,5,4,0,1
"GNA12",31,21,10,0,1
"GNA13",48,34,14,0,1
"ARHGEF12",41,35,6,0,1
"CD44",27,12,15,0,1
"IGF1R",119,101,18,0,1
"ARHGEF7",19,12,7,0,1
"CBLB",38,28,10,0,1
"SMARCE1",15,10,5,0,1
"E2F1",384,44,340,0,1
"E2F2",78,64,14,0,1
"HDAC2",50,44,6,0,1
"SIN3A",57,51,6,0,1
"UBE2L3",19,15,4,0,1
"ARL15",19,13,6,0,1
"GAPDH",69,48,21,0,1
"RPL8",14,11,3,0,1
"UBR1",32,19,13,0,1
"TLE1",25,22,3,0,1
"ATP5J2",13,10,3,0,1
"PRMT1",30,18,12,0,1
"RNF130",8,6,2,0,1
"CSNK2A2",38,29,9,0,1
"FLNA",69,51,18,0,1
"HIPK3",65,59,6,0,1
"MAPK1",133,103,30,0,1
"MED8",34,28,6,0,1
"HCK",51,34,17,0,1
"SH3KBP1",47,42,5,0,1
"SNRPB",36,33,3,0,1
"MEF2A",37,23,14,0,1
"ASF1A",26,25,1,0,1
"H3F3A",12,11,1,0,1
"ASGR1",14,11,3,0,1
"ASIP",3,2,1,0,1
"F11R",20,15,5,0,1
"CREB1",182,52,130,0,1
"GABPB1",43,37,6,0,1
"SPI1",149,20,129,0,1
"HIST2H2BE",16,13,3,0,1
"HMGA1",61,51,10,0,1
"BATF3",6,5,1,0,1
"CEBPG",27,22,5,0,1
"DDIT3",16,8,8,0,1
"CDC34",17,16,1,0,1
"POLR2D",48,45,3,0,1
"TOPBP1",19,15,4,0,1
"WRN",15,12,3,0,1
"XRCC5",35,28,7,0,1
"ATN1",55,31,24,0,1
"EWSR1",51,25,26,0,1
"TRIP6",25,17,8,0,1
"BCL2",80,63,17,0,1
"CSE1L",44,42,2,0,1
"ATP5C1",23,19,4,0,1
"PSME3",33,27,6,0,1
"RPP14",20,18,2,0,1
"ATR",15,9,6,0,1
"EZH2",200,27,173,0,1
"ZNF512B",43,33,10,0,1
"DAZAP2",70,61,9,0,1
"PSMC3",10,6,4,0,1
"RAD23A",21,15,6,0,1
"RNF11",73,53,20,0,1
"NME1",21,16,5,0,1
"PPP1CA",34,28,6,0,1
"PPP1CC",36,33,3,0,1
"GNAS",32,28,4,0,1
"AXIN1",35,16,19,0,1
"DAB2",46,38,8,0,1
"DVL1",18,12,6,0,1
"DVL3",33,29,4,0,1
"JUP",24,18,6,0,1
"PPP2CA",65,54,11,0,1
"SH3GL1",25,17,8,0,1
"UTP14A",21,15,6,0,1
"AXL",42,29,13,0,1
"CBL",94,61,33,0,1
"IL2RG",13,8,5,0,1
"PIK3R2",24,16,8,0,1
"PIK3R3",26,21,5,0,1
"B2M",23,20,3,0,1
"HLA-A",21,14,7,0,1
"PRSS23",24,18,6,0,1
"PLSCR1",35,17,18,0,1
"PSEN1",42,24,18,0,1
"MAFK",111,29,82,0,1
"MAPK8",58,51,7,0,1
"PIM1",23,19,4,0,1
"YWHAQ",76,62,14,0,1
"KRTAP4-12",5,2,3,0,1
"PHYHIP",34,25,9,0,1
"SHANK1",13,3,10,0,1
"STARD13",38,34,4,0,1
"BAIAP2",15,10,5,0,1
"NCKIPSD",26,23,3,0,1
"BRD7",29,25,4,0,1
"IKBKAP",21,18,3,0,1
"CREB3L3",4,2,2,0,1
"BID",40,32,8,0,1
"MAP3K7",41,32,9,0,1
"CASP1",21,10,11,0,1
"CASP8",41,20,21,0,1
"CD2AP",49,45,4,0,1
"FAM46A",14,12,2,0,1
"CDK2",85,76,9,0,1
"CYCS",55,54,1,0,1
"HRK",31,30,1,0,1
"SF1",22,19,3,0,1
"BCL3",27,10,17,0,1
"NFKB2",40,12,28,0,1
"IRF4",54,27,27,0,1
"ERCC3",14,10,4,0,1
"RBL1",50,46,4,0,1
"BMP4",9,5,4,0,1
"NEK9",56,55,1,0,1
"DNM2",33,24,9,0,1
"BIRC2",25,11,14,0,1
"CASP7",24,19,5,0,1
"DIABLO",20,16,4,0,1
"UBB",38,23,15,0,1
"BLK",5,2,3,0,1
"FCGR2B",6,2,4,0,1
"BLNK",19,12,7,0,1
"NAP1L4",17,15,2,0,1
"BMI1",31,28,3,0,1
"CBX8",25,22,3,0,1
"RING1",15,12,3,0,1
"RNF2",22,18,4,0,1
"COL7A1",15,12,3,0,1
"BMP2",36,31,5,0,1
"BMPR2",76,63,13,0,1
"GDF9",16,4,12,0,1
"STUB1",18,5,13,0,1
"TUBB",68,55,13,0,1
"PTK2",73,40,33,0,1
"BNIP3L",34,29,5,0,1
"ROBO2",29,21,8,0,1
"BRCA2",16,12,4,0,1
"CTBP2",19,17,2,0,1
"NFYA",115,32,83,0,1
"NMI",15,14,1,0,1
"RFC1",21,18,3,0,1
"BTBD2",23,21,2,0,1
"HIST4H4",12,10,2,0,1
"RBL2",42,36,6,0,1
"PDLIM7",18,13,5,0,1
"TRIM5",9,8,1,0,1
"BTK",52,8,44,0,1
"KHDRBS1",36,30,6,0,1
"KIT",55,26,29,0,1
"LYN",99,56,43,0,1
"MYD88",26,18,8,0,1
"PLCG2",61,43,18,0,1
"PRKCQ",15,8,7,0,1
"SYK",56,20,36,0,1
"TNFRSF14",21,12,9,0,1
"BTRC",54,41,13,0,1
"SKP1",37,32,5,0,1
"WEE1",27,21,6,0,1
"BUB1",31,26,5,0,1
"PLK1",57,34,23,0,1
"BUB1B",10,8,2,0,1
"C11orf58",23,17,6,0,1
"KIAA1377",55,22,33,0,1
"RPLP1",35,27,8,0,1
"SF3B1",24,19,5,0,1
"POLR2C",17,14,3,0,1
"TSNAX",11,9,2,0,1
"C1QBP",23,19,4,0,1
"DCN",24,14,10,0,1
"UBQLN4",69,37,32,0,1
"C5",5,3,2,0,1
"C6",6,5,1,0,1
"FGFR3",24,13,11,0,1
"C7orf25",13,9,4,0,1
"C8orf33",34,29,5,0,1
"FEZ1",26,8,18,0,1
"IMMT",30,15,15,0,1
"CA2",5,4,1,0,1
"CCNE1",38,32,6,0,1
"CACHD1",16,14,2,0,1
"XAB2",8,3,5,0,1
"RIMS1",6,3,3,0,1
"CACNA1C",52,51,1,0,1
"REM1",4,2,2,0,1
"MPP3",8,7,1,0,1
"CALCOCO2",32,24,8,0,1
"DAXX",26,20,6,0,1
"GABARAPL2",9,8,1,0,1
"GPRASP2",20,8,12,0,1
"LYST",21,18,3,0,1
"TTN",12,5,7,0,1
"CALR",63,46,17,0,1
"THBS1",83,71,12,0,1
"TRAF6",58,24,34,0,1
"CAMK1",5,2,3,0,1
"KRT18",31,20,11,0,1
"CAMLG",20,16,4,0,1
"KCNA3",6,4,2,0,1
"LBP",5,4,1,0,1
"CANX",56,46,10,0,1
"EBI3",11,10,1,0,1
"CAPNS1",14,9,5,0,1
"CAPRIN1",32,31,1,0,1
"TRAF1",57,39,18,0,1
"TSC22D1",35,31,4,0,1
"CASK",34,16,18,0,1
"CNTNAP2",12,9,3,0,1
"PRKD2",22,18,4,0,1
"PLA2G4A",28,19,9,0,1
"DSP",15,14,1,0,1
"EEF1A1",71,45,26,0,1
"EIF2AK2",53,38,15,0,1
"PTMA",46,28,18,0,1
"STK4",42,41,1,0,1
"TOP1",24,22,2,0,1
"CASP4",14,6,8,0,1
"CLSPN",35,34,1,0,1
"RIPK1",15,10,5,0,1
"RYBP",60,57,3,0,1
"RNF19A",22,14,8,0,1
"SUMO4",12,5,7,0,1
"ILK",32,23,9,0,1
"IRS1",64,47,17,0,1
"PTPRF",27,22,5,0,1
"DNAJA1",38,32,6,0,1
"CD5",18,14,4,0,1
"ITCH",23,19,4,0,1
"CBX2",49,48,1,0,1
"TAF4",30,22,8,0,1
"TRIM28",25,23,2,0,1
"MCM10",32,22,10,0,1
"CCR5",28,18,10,0,1
"MMP3",14,10,4,0,1
"CCR1",9,7,2,0,1
"VCAN",64,52,12,0,1
"DPP4",17,9,8,0,1
"CCR3",13,5,8,0,1
"IL8",11,10,1,0,1
"CCL5",22,14,8,0,1
"SDC1",19,13,6,0,1
"MMP14",33,21,12,0,1
"CCNB1",75,61,14,0,1
"CDC25C",14,9,5,0,1
"GADD45G",34,21,13,0,1
"CDK9",31,21,10,0,1
"JAK1",73,45,28,0,1
"CD4",45,27,18,0,1
"PTK2B",50,24,26,0,1
"TXK",15,11,4,0,1
"PAFAH1B2",47,45,2,0,1
"VHL",26,20,6,0,1
"ITGB2",32,10,22,0,1
"ITGB1",80,48,32,0,1
"PTPRC",32,19,13,0,1
"CD2",14,8,6,0,1
"CD244",7,5,2,0,1
"LAT",21,9,12,0,1
"CD247",21,5,16,0,1
"CSK",29,21,8,0,1
"SIVA1",12,10,2,0,1
"TRAF2",87,17,70,0,1
"TRAF3",19,14,5,0,1
"CD28",29,16,13,0,1
"GRAP2",45,31,14,0,1
"PKD2",26,24,2,0,1
"CD3E",16,10,6,0,1
"IL16",21,16,5,0,1
"GNAI1",48,27,21,0,1
"ITGAV",37,27,10,0,1
"UBQLN1",33,25,8,0,1
"CD48",11,7,4,0,1
"IL2",9,7,2,0,1
"SDCBP",39,32,7,0,1
"HLA-DRA",14,11,3,0,1
"CD81",21,16,5,0,1
"ITGA4",19,14,5,0,1
"HBEGF",30,24,6,0,1
"CD8A",12,5,7,0,1
"COL4A1",32,26,6,0,1
"COL4A3",20,13,7,0,1
"MELK",44,43,1,0,1
"SAFB",20,14,6,0,1
"ITSN1",51,43,8,0,1
"CDH2",34,27,7,0,1
"GRIN2D",26,17,9,0,1
"PKP4",20,19,1,0,1
"CDK5RAP1",6,4,2,0,1
"CDKN1B",28,19,9,0,1
"PAX6",14,9,5,0,1
"GATA2",108,12,96,0,1
"MYB",148,20,128,0,1
"SMARCC1",28,20,8,0,1
"TAF9",24,17,7,0,1
"FOSL2",130,65,65,0,1
"TP53",63,12,51,0,1
"SPTBN4",24,19,5,0,1
"PIN1",54,36,18,0,1
"SNAP25",16,14,2,0,1
"NEK2",12,7,5,0,1
"CHEK2",41,28,13,0,1
"CHFR",14,10,4,0,1
"CHGB",9,4,5,0,1
"POLR2E",22,18,4,0,1
"CHM",9,8,1,0,1
"CHMP1B",15,13,2,0,1
"CHMP2A",8,6,2,0,1
"MAPK8IP2",32,20,12,0,1
"GNA15",5,3,2,0,1
"WWP1",29,25,4,0,1
"GADD45A",35,23,12,0,1
"ICAM3",6,4,2,0,1
"TYROBP",8,6,2,0,1
"GOLM1",19,17,2,0,1
"HGS",37,20,17,0,1
"CMA1",5,2,3,0,1
"CNKSR1",7,5,2,0,1
"CNKSR2",23,20,3,0,1
"CNOT7",15,12,3,0,1
"MET",57,38,19,0,1
"LIFR",44,40,4,0,1
"HN1L",12,11,1,0,1
"CNTN1",19,16,3,0,1
"PTPRB",33,29,4,0,1
"RTN4",23,13,10,0,1
"KCNA2",10,8,2,0,1
"COG4",3,2,1,0,1
"MAD1L1",9,7,2,0,1
"COL13A1",25,20,5,0,1
"PPL",20,18,2,0,1
"KDR",51,29,22,0,1
"IGFBP3",35,27,8,0,1
"COL2A1",20,12,8,0,1
"PXN",55,30,25,0,1
"XRN2",14,9,5,0,1
"MAPK14",60,48,12,0,1
"TRIM37",40,32,8,0,1
"COPS3",11,6,5,0,1
"COPS5",17,15,2,0,1
"GPS1",19,13,6,0,1
"CPE",32,27,5,0,1
"RPA1",19,6,13,0,1
"NUDT21",33,23,10,0,1
"GLI2",44,31,13,0,1
"NFIL3",18,17,1,0,1
"DACH1",30,24,6,0,1
"EBF1",167,31,136,0,1
"ETS1",202,60,142,0,1
"GATA1",220,7,213,0,1
"MAFG",18,14,4,0,1
"NCOA6",33,26,7,0,1
"NFIC",101,43,58,0,1
"PROX1",44,37,7,0,1
"SNIP1",38,33,5,0,1
"TUBB2A",31,29,2,0,1
"FRS2",82,75,7,0,1
"IRS2",37,30,7,0,1
"CRKL",62,42,20,0,1
"GAB2",13,8,5,0,1
"TGFB1I1",23,22,1,0,1
"PPP1R8",17,10,7,0,1
"CSF1",26,23,3,0,1
"INPP5D",19,9,10,0,1
"FES",12,8,4,0,1
"HNRNPK",38,28,10,0,1
"HDAC3",24,19,5,0,1
"ERCC8",8,6,2,0,1
"POLR2B",16,15,1,0,1
"SNRNP70",19,14,5,0,1
"CTGF",43,41,2,0,1
"NOV",15,10,5,0,1
"RUVBL1",11,10,1,0,1
"ZFYVE9",25,19,6,0,1
"FAM118B",13,12,1,0,1
"LGALS3",16,12,4,0,1
"NCF4",6,5,1,0,1
"FMR1",26,23,3,0,1
"FXR2",33,22,11,0,1
"TRIM23",30,24,6,0,1
"DAG1",26,19,7,0,1
"MCM7",49,38,11,0,1
"UPF1",16,11,5,0,1
"RPGR",5,4,1,0,1
"NIF3L1",29,23,6,0,1
"SNAPIN",15,10,5,0,1
"EIF3E",20,16,4,0,1
"NUP62",20,19,1,0,1
"DEK",31,29,2,0,1
"SRRM1",7,3,4,0,1
"MYO15A",2,1,1,0,1
"HSPD1",40,33,7,0,1
"PTCH1",19,18,1,0,1
"DIAPH2",26,25,1,0,1
"DLEU1",9,6,3,0,1
"PSMA1",18,9,9,0,1
"DLG1",43,11,32,0,1
"GNG13",3,2,1,0,1
"MAPK12",13,4,9,0,1
"DLG2",48,27,21,0,1
"DLGAP1",11,5,6,0,1
"NOS1",19,11,8,0,1
"DLG3",35,16,19,0,1
"SYNGAP1",26,24,2,0,1
"YES1",39,32,7,0,1
"DLST",9,7,2,0,1
"DYNLL2",47,45,2,0,1
"DLGAP4",14,11,3,0,1
"FLII",13,10,3,0,1
"SOX10",21,9,12,0,1
"SOX8",16,11,5,0,1
"NUDT3",50,36,14,0,1
"DNAJC3",26,23,3,0,1
"HSPA1B",22,21,1,0,1
"DNMBP",21,18,3,0,1
"TRIM27",19,17,2,0,1
"KIAA1279",23,19,4,0,1
"DPM2",13,12,1,0,1
"DPPA2",5,2,3,0,1
"SH3GL3",17,4,13,0,1
"MPDZ",15,9,6,0,1
"GABRA1",5,3,2,0,1
"NCK1",53,15,38,0,1
"KRT5",6,3,3,0,1
"MAPK11",9,7,2,0,1
"DUSP23",13,7,6,0,1
"PRPF3",4,2,2,0,1
"DYNC1I1",16,11,5,0,1
"PNN",13,8,5,0,1
"PARD3",17,10,7,0,1
"E2F6",200,26,174,0,1
"TFDP1",19,15,4,0,1
"TFDP2",37,33,4,0,1
"E2F3",134,73,61,0,1
"ECH1",10,6,4,0,1
"RHOG",17,14,3,0,1
"EDA",6,5,1,0,1
"GRK6",20,16,4,0,1
"EXOSC4",19,9,10,0,1
"EEF1B2",6,4,2,0,1
"MVD",4,3,1,0,1
"EEF2K",25,19,6,0,1
"EFNA1",22,19,3,0,1
"EFNA3",14,13,1,0,1
"EFNA5",37,36,1,0,1
"EPHB2",34,20,14,0,1
"EFNB1",25,20,5,0,1
"PTPN13",19,14,5,0,1
"RGS3",16,12,4,0,1
"HOMER1",28,19,9,0,1
"SNRPD2",18,9,9,0,1
"NPM1",26,18,8,0,1
"EIF3F",11,8,3,0,1
"EIF4E",20,18,2,0,1
"GNB2L1",36,29,7,0,1
"ID2",20,13,7,0,1
"ELN",21,19,2,0,1
"FYB",15,5,10,0,1
"TES",35,30,5,0,1
"ING4",8,6,2,0,1
"EPHB3",9,6,3,0,1
"GRAP",11,8,3,0,1
"SYNCRIP",66,64,2,0,1
"HOOK2",9,7,2,0,1
"FLI1",260,26,234,0,1
"SMARCA2",23,20,3,0,1
"ETF1",15,14,1,0,1
"MAF",62,38,24,0,1
"RAB27A",30,21,9,0,1
"F10",14,9,5,0,1
"SGTA",13,8,5,0,1
"TJP1",47,36,11,0,1
"PROC",5,4,1,0,1
"SERPINC1",12,10,2,0,1
"F2R",35,26,9,0,1
"PRTN3",6,5,1,0,1
"F2RL2",21,18,3,0,1
"RAP1A",36,22,14,0,1
"RABAC1",38,25,13,0,1
"TNFRSF1A",40,18,22,0,1
"HDAC6",12,10,2,0,1
"FCER1G",10,4,6,0,1
"ZAP70",34,4,30,0,1
"MEST",7,5,2,0,1
"FGFR1",38,31,7,0,1
"HSPA9",25,22,3,0,1
"SYT1",27,23,4,0,1
"RPS6KA3",81,70,11,0,1
"HNRNPL",33,28,5,0,1
"ICAM1",21,18,3,0,1
"FIGF",5,3,2,0,1
"FLNB",26,23,3,0,1
"NPHP1",11,9,2,0,1
"SHBG",5,1,4,0,1
"SYNJ1",24,16,8,0,1
"FOXA2",44,1,43,0,1
"NR1H3",27,10,17,0,1
"MPHOSPH6",13,9,4,0,1
"TAF10",20,9,11,0,1
"SLC35E1",11,9,2,0,1
"PRKCH",16,14,2,0,1
"GIPC1",26,18,8,0,1
"WNT1",19,16,3,0,1
"MAP3K3",52,48,4,0,1
"GABARAP",14,7,7,0,1
"PPP3CA",24,15,9,0,1
"PRKCG",12,3,9,0,1
"GABRB2",25,23,2,0,1
"TRAK2",25,23,2,0,1
"GAL",10,9,1,0,1
"GNAQ",51,35,16,0,1
"GAP43",18,17,1,0,1
"IARS",15,14,1,0,1
"GAS1",28,26,2,0,1
"NR5A1",7,3,4,0,1
"MBD3",186,28,158,0,1
"GBP2",15,7,8,0,1
"GDE1",40,39,1,0,1
"S100A8",17,14,3,0,1
"NCAM1",20,15,5,0,1
"RET",25,10,15,0,1
"GGA1",27,21,6,0,1
"GGA2",33,23,10,0,1
"RABEP1",33,30,3,0,1
"GGA3",18,15,3,0,1
"TSG101",23,15,8,0,1
"GHRL",3,1,2,0,1
"RGS19",19,11,8,0,1
"NUDT18",18,12,6,0,1
"PLEKHF2",36,34,2,0,1
"GMEB1",16,10,6,0,1
"TRPC3",21,14,7,0,1
"TSHR",12,4,8,0,1
"GPSM2",21,18,3,0,1
"GNAI3",26,16,10,0,1
"PLCB1",24,19,5,0,1
"GOLGA2",29,19,10,0,1
"IGF2",55,49,6,0,1
"LRSAM1",14,8,6,0,1
"SHB",15,12,3,0,1
"GRASP",8,5,3,0,1
"NGFR",44,25,19,0,1
"USP8",21,19,2,0,1
"VAV3",67,58,9,0,1
"PPM1A",44,38,6,0,1
"TUBA1B",36,34,2,0,1
"SGK1",47,43,4,0,1
"TAF1C",12,9,3,0,1
"HAND2",52,24,28,0,1
"HEY2",13,12,1,0,1
"HEYL",43,39,4,0,1
"TCF3",172,21,151,0,1
"MMP2",56,35,21,0,1
"PSMD4",11,9,2,0,1
"SPOP",23,21,2,0,1
"NR4A1",26,8,18,0,1
"HEXDC",7,4,3,0,1
"SMAD7",45,33,12,0,1
"PLAU",16,12,4,0,1
"HLA-B",14,10,4,0,1
"HLA-C",16,8,8,0,1
"HSPA5",35,21,14,0,1
"MBP",28,7,21,0,1
"IRF1",65,16,49,0,1
"NR1H2",35,8,27,0,1
"SEPT2",4,1,3,0,1
"TNPO1",62,58,4,0,1
"PKNOX1",20,19,1,0,1
"MEIS1",46,37,9,0,1
"PBX1",116,34,82,0,1
"HOXC8",30,28,2,0,1
"TAF1",153,16,137,0,1
"NUAK1",44,36,8,0,1
"S1PR1",56,53,3,0,1
"HTRA1",18,9,9,0,1
"ICAM4",4,3,1,0,1
"IFNAR1",26,18,8,0,1
"TYK2",15,8,7,0,1
"IFNAR2",46,42,4,0,1
"IGBP1",13,11,2,0,1
"IGF1",86,84,2,0,1
"IGFBP5",38,33,5,0,1
"RANBP10",8,7,1,0,1
"IKZF1",33,11,22,0,1
"IKZF4",19,17,2,0,1
"IKZF5",35,33,2,0,1
"IL12B",5,4,1,0,1
"IL4R",18,8,10,0,1
"IL2RB",19,6,13,0,1
"IL18",7,4,3,0,1
"IL1RAP",35,27,8,0,1
"NDN",21,16,5,0,1
"TICAM2",10,4,6,0,1
"IL21",2,1,1,0,1
"PTPN6",60,12,48,0,1
"IRAK1",52,26,26,0,1
"TRAF4",20,13,7,0,1
"IRF2",16,11,5,0,1
"IRF3",22,13,9,0,1
"ITGA2",38,29,9,0,1
"ITGB7",10,3,7,0,1
"ITGB5",26,13,13,0,1
"LTB",9,7,2,0,1
"RANBP9",20,16,4,0,1
"VTN",11,3,8,0,1
"PRKG1",48,34,14,0,1
"PPIA",29,25,4,0,1
"VTA1",35,31,4,0,1
"KHSRP",33,29,4,0,1
"ZNF638",31,25,6,0,1
"LAIR1",9,8,1,0,1
"LAMA2",7,6,1,0,1
"LEF1",21,11,10,0,1
"LIMS1",31,26,5,0,1
"TMPO",39,35,4,0,1
"LRP3",16,14,2,0,1
"LSM2",9,3,6,0,1
"LSM4",19,14,5,0,1
"LSM5",14,9,5,0,1
"LSM7",15,4,11,0,1
"PTCD3",18,17,1,0,1
"ZHX1",34,26,8,0,1
"MED12",11,9,2,0,1
"PDX1",5,2,3,0,1
"MAP1B",86,77,9,0,1
"MAP2K6",21,19,2,0,1
"MAP3K5",36,22,14,0,1
"PHC2",19,15,4,0,1
"RAI1",18,15,3,0,1
"MAPK8IP3",29,16,13,0,1
"SNAP23",32,24,8,0,1
"TTF2",37,27,10,0,1
"MAZ",162,30,132,0,1
"SRPK1",39,37,2,0,1
"POMC",6,3,3,0,1
"MED9",14,10,4,0,1
"MEF2D",69,65,4,0,1
"MEP1B",2,1,1,0,1
"MINK1",40,36,4,0,1
"OSGEP",10,2,8,0,1
"SYNE1",36,31,5,0,1
"MYCN",71,12,59,0,1
"ZFHX3",53,52,1,0,1
"RAB11A",45,42,3,0,1
"PNKP",6,4,2,0,1
"NCF2",7,4,3,0,1
"RORA",91,86,5,0,1
"RORB",50,46,4,0,1
"RXRB",26,17,9,0,1
"NR1D2",17,15,2,0,1
"NR1D1",4,2,2,0,1
"SDCBP2",4,2,2,0,1
"TLX1",27,11,16,0,1
"RELB",15,9,6,0,1
"NTRK1",16,3,13,0,1
"SMPD1",12,11,1,0,1
"NKX2-1",11,3,8,0,1
"NLGN3",11,8,3,0,1
"SFPQ",124,46,78,0,1
"NOP2",16,14,2,0,1
"NPPA",4,2,2,0,1
"NPR1",42,40,2,0,1
"PYY",3,2,1,0,1
"NPY2R",4,3,1,0,1
"RXRG",8,6,2,0,1
"SIX3",14,11,3,0,1
"STX4",18,12,6,0,1
"NUP98",23,17,6,0,1
"RANBP2",45,33,12,0,1
"PABPC1",41,31,10,0,1
"BACH2",76,65,11,0,1
"WT1",16,12,4,0,1
"YBX1",29,23,6,0,1
"RAD50",10,7,3,0,1
"PDGFRB",43,18,25,0,1
"PEX5",14,9,5,0,1
"PFN2",35,31,4,0,1
"SCMH1",6,4,2,0,1
"RND1",5,2,3,0,1
"POLDIP2",23,19,4,0,1
"TAF15",20,16,4,0,1
"POLR3F",15,12,3,0,1
"PPP1CB",30,29,1,0,1
"PRIM1",26,25,1,0,1
"XPA",8,5,3,0,1
"PRLR",43,31,12,0,1
"SNRPD1",67,61,6,0,1
"PROS1",5,2,3,0,1
"PTGDS",7,4,3,0,1
"PTGFR",14,12,2,0,1
"PTPRE",15,9,6,0,1
"RABGGTB",14,13,1,0,1
"RAB3A",7,4,3,0,1
"RAB5B",56,52,4,0,1
"RDH11",18,16,2,0,1
"RFX2",7,5,2,0,1
"RFX3",21,19,2,0,1
"RINT1",8,6,2,0,1
"SMAD5",52,42,10,0,1
"SLC9A3",5,3,2,0,1
"SIX5",60,17,43,0,1
"SOX5",28,26,2,0,1
"ZNF76",27,10,17,0,1
"TCEB1",39,35,4,0,1
"SOX6",38,37,1,0,1
"SREBF2",14,8,6,0,1
"NKX3-1",21,8,13,0,1
"SPOCK2",11,10,1,0,1
"STAT4",12,4,8,0,1
"TF",9,2,7,0,1
"YEATS4",9,8,1,0,1
"TFAP2C",109,12,97,0,1
"TM4SF1",10,7,3,0,1
"TNFSF10",10,9,1,0,1
"TNFSF12",4,3,1,0,1
"TNFRSF13C",24,22,2,0,1
"TNFRSF4",6,1,5,0,1
"ZBTB43",24,22,2,0,1
"ZNF417",26,24,2,0,1
"ZNF165",3,2,1,0,1
"ZNF250",9,6,3,0,1
"ZNF446",16,14,2,0,1
"DPF2",14,13,1,0,1
"SP2",44,9,35,0,1
"ASH2L",7,5,2,0,1
"KLF2",39,36,3,0,1
"hsa-miR-128-2-5p",26,18,8,0,1
"hsa-miR-130a-5p",555,21,534,0,1
"hsa-miR-141-5p",414,42,372,0,1
"hsa-miR-146a-5p",222,48,174,0,1
"hsa-miR-181a-5p",468,33,435,0,1
"hsa-miR-18a-5p",480,63,417,0,1
"hsa-miR-223-5p",193,31,162,0,1
"hsa-miR-23a-5p",611,37,574,0,1
"hsa-miR-31-5p",217,12,205,0,1
"hsa-miR-3614-5p",87,51,36,0,1
"hsa-miR-3648",95,93,2,0,1
"hsa-miR-4745-5p",44,30,14,0,1
"hsa-miR-584-5p",57,27,30,0,1
"hsa-miR-615-5p",239,16,223,0,1
"hsa-miR-624-5p",17,8,9,0,1
"hsa-miR-663a",94,72,22,0,1
"hsa-miR-9-5p",551,46,505,0,1
