"Name","K","Kin","Kout","TypeI","TypeII"
"ANXA7",56,42,14,0,1
"TK1",80,56,24,0,1
"A2M",21,8,13,0,1
"ATF7IP",110,91,19,0,1
"H2AFX",55,47,8,0,1
"HMOX2",22,12,10,0,1
"MYOC",9,4,5,0,1
"NUDT21",50,41,9,0,1
"RAP1B",79,76,3,0,1
"MAP1LC3B",34,30,4,0,1
"MDFI",43,40,3,0,1
"RB1",141,117,24,0,1
"ABCA1",57,51,6,0,1
"CSNK2A1",141,116,25,0,1
"HAX1",20,18,2,0,1
"RDX",58,53,5,0,1
"ABL1",88,60,28,0,1
"EPS8",48,43,5,0,1
"NCK2",45,34,11,0,1
"SOS1",80,62,18,0,1
"SOS2",40,35,5,0,1
"ATM",57,41,16,0,1
"CAV1",109,79,30,0,1
"CRK",146,121,25,0,1
"PLSCR1",43,30,13,0,1
"POLR2A",71,63,8,0,1
"PRKD1",35,29,6,0,1
"PTPN12",48,45,3,0,1
"RAN",63,58,5,0,1
"YWHAE",102,92,10,0,1
"YWHAG",206,166,40,0,1
"HOOK2",10,9,1,0,1
"ATXN1",167,142,25,0,1
"CSNK2A2",38,28,10,0,1
"USP7",36,32,4,0,1
"FYN",156,98,58,0,1
"SPTAN1",20,14,6,0,1
"ACTA1",25,13,12,0,1
"GSN",40,34,6,0,1
"MYLK",82,78,4,0,1
"PFN1",54,44,10,0,1
"PRKCD",31,20,11,0,1
"VCL",137,106,31,0,1
"ACTB",126,106,20,0,1
"CDKN1A",90,83,7,0,1
"CFL1",25,20,5,0,1
"LMNA",27,23,4,0,1
"PFDN1",19,11,8,0,1
"ACTC1",16,12,4,0,1
"DYNLL1",33,24,9,0,1
"MAPK6",151,116,35,0,1
"PDPK1",83,72,11,0,1
"PIP4K2C",38,33,5,0,1
"ARHGDIA",56,54,2,0,1
"ACTN1",49,41,8,0,1
"KAT2B",55,50,5,0,1
"ACTN4",48,44,4,0,1
"CAMK2G",39,36,3,0,1
"DCTN1",20,17,3,0,1
"CHD3",33,25,8,0,1
"CDC42",75,56,19,0,1
"ACVR1",76,57,19,0,1
"AP2B1",45,38,7,0,1
"RAP2A",40,33,7,0,1
"SOCS6",47,42,5,0,1
"STX8",7,5,2,0,1
"ACVR2A",83,81,2,0,1
"TGFB1",33,23,10,0,1
"TGFB3",11,8,3,0,1
"TGFBR2",132,121,11,0,1
"GRB2",72,46,26,0,1
"ADAM10",56,54,2,0,1
"ADAM17",50,43,7,0,1
"NOTCH1",57,48,9,0,1
"TNFSF11",21,15,6,0,1
"RYR1",6,3,3,0,1
"FN1",106,85,21,0,1
"PRKCA",142,79,63,0,1
"RAF1",53,39,14,0,1
"ADCYAP1",37,36,1,0,1
"CALM1",75,61,14,0,1
"EDN1",31,29,2,0,1
"ADRBK1",44,34,10,0,1
"GNAI2",53,43,10,0,1
"YWHAZ",151,118,33,0,1
"ADRB2",20,15,5,0,1
"GPRASP1",24,11,13,0,1
"GRK5",31,25,6,0,1
"GRK6",32,27,5,0,1
"SLC9A3R1",29,21,8,0,1
"CSNK2B",70,26,44,0,1
"GIT1",40,29,11,0,1
"SRC",44,23,21,0,1
"CXCR4",29,19,10,0,1
"AES",17,15,2,0,1
"PRKCB",66,53,13,0,1
"PRKCE",37,28,9,0,1
"ATXN1L",100,91,9,0,1
"CCNT1",60,59,1,0,1
"SGSM2",28,25,3,0,1
"UBE3A",58,53,5,0,1
"AGFG1",75,71,4,0,1
"CCDC85B",74,59,15,0,1
"CTSG",20,10,10,0,1
"CDKN2A",28,27,1,0,1
"EP300",165,144,21,0,1
"NCOA1",103,74,29,0,1
"NCOA2",77,63,14,0,1
"TAF4",26,21,5,0,1
"AIP",21,20,1,0,1
"PRKAR2A",84,78,6,0,1
"AKAP10",32,29,3,0,1
"PRKAR1A",68,55,13,0,1
"GSK3B",141,102,39,0,1
"YWHAB",103,83,20,0,1
"KPNB1",87,75,12,0,1
"PRPF40A",88,71,17,0,1
"AKAP9",32,28,4,0,1
"PKN1",21,17,4,0,1
"AKT1",88,57,31,0,1
"BAD",23,12,11,0,1
"CHUK",56,42,14,0,1
"EIF4EBP1",35,32,3,0,1
"ITSN1",62,55,7,0,1
"MDM2",123,114,9,0,1
"PPP2CA",67,59,8,0,1
"PTEN",99,93,6,0,1
"XRN1",82,76,6,0,1
"PLCG1",105,74,31,0,1
"PTN",32,16,16,0,1
"SSSCA1",13,12,1,0,1
"TOM1L1",13,6,7,0,1
"EGFR",131,84,47,0,1
"AMOTL2",54,52,2,0,1
"KRT15",8,6,2,0,1
"DNM1",25,19,6,0,1
"TEK",18,9,9,0,1
"NFASC",34,32,2,0,1
"SLC4A1",24,23,1,0,1
"ANK2",27,25,2,0,1
"ANK3",49,47,2,0,1
"HDAC4",52,48,4,0,1
"BCL2L1",64,58,6,0,1
"ANXA1",21,13,8,0,1
"COPS6",56,39,17,0,1
"PRKCI",35,29,6,0,1
"TGM2",24,19,5,0,1
"UNC119",44,22,22,0,1
"XRCC6",45,41,4,0,1
"ANXA11",21,20,1,0,1
"S100A6",4,3,1,0,1
"C14orf1",32,28,4,0,1
"CCDC90B",15,13,2,0,1
"MED31",28,24,4,0,1
"AP1M1",33,27,6,0,1
"DVL2",27,19,8,0,1
"AP2A1",25,21,4,0,1
"HTT",47,38,9,0,1
"AP2M1",23,19,4,0,1
"SMURF1",72,71,1,0,1
"MEGF10",6,4,2,0,1
"AP3B1",45,42,3,0,1
"CLTC",101,88,13,0,1
"CSNK1A1",68,61,7,0,1
"XPOT",59,57,2,0,1
"CASP3",113,73,40,0,1
"HSPA1A",54,43,11,0,1
"NLRP1",10,9,1,0,1
"APP",102,78,24,0,1
"APLP2",41,40,1,0,1
"APC",56,53,3,0,1
"CTBP1",57,50,7,0,1
"APEX1",51,47,4,0,1
"UBE2I",65,57,8,0,1
"PCNA",47,41,6,0,1
"LNX1",19,11,8,0,1
"SETDB1",40,31,9,0,1
"VIM",79,64,15,0,1
"KPNA2",55,53,2,0,1
"LRP1",51,38,13,0,1
"APPBP2",50,48,2,0,1
"FBLN1",14,9,5,0,1
"HSPG2",35,30,5,0,1
"NID1",46,43,3,0,1
"SNCA",26,14,12,0,1
"TP53BP2",31,29,2,0,1
"EFEMP2",20,16,4,0,1
"CDC37",49,43,6,0,1
"CREBBP",276,79,197,0,1
"GTF2H1",48,45,3,0,1
"NCOR1",102,49,53,0,1
"RNF4",31,30,1,0,1
"RUNX1",572,83,489,0,1
"SMAD1",209,36,173,0,1
"SMAD3",130,43,87,0,1
"TRIM24",39,31,8,0,1
"ARAF",17,15,2,0,1
"UBQLN4",26,18,8,0,1
"HSP90AB1",33,31,2,0,1
"PIK3R1",144,96,48,0,1
"PTPN11",93,54,39,0,1
"TUBA4A",25,16,9,0,1
"TGFBR1",140,102,38,0,1
"RASA1",52,37,15,0,1
"SMURF2",87,65,22,0,1
"RBPMS",33,31,2,0,1
"CBX5",142,135,7,0,1
"ARHGEF11",16,13,3,0,1
"GNA12",32,24,8,0,1
"GNA13",84,71,13,0,1
"ARHGEF12",55,50,5,0,1
"CD44",30,26,4,0,1
"IGF1R",132,116,16,0,1
"ARHGEF6",23,18,5,0,1
"ARHGEF7",34,27,7,0,1
"CBLB",51,43,8,0,1
"SMARCE1",35,30,5,0,1
"E2F2",63,55,8,0,1
"SIN3A",65,59,6,0,1
"UBE2L3",21,19,2,0,1
"GAPDH",60,42,18,0,1
"UBR1",45,34,11,0,1
"ATP5J2",14,12,2,0,1
"HIF1A",570,87,483,0,1
"WAS",24,12,12,0,1
"MAP2K7",48,43,5,0,1
"DVL1",28,22,6,0,1
"MAPK3",50,38,12,0,1
"ARRB2",36,24,12,0,1
"FLNA",62,47,15,0,1
"HIPK3",107,101,6,0,1
"MAPK1",214,188,26,0,1
"SH3KBP1",53,46,7,0,1
"ASCC2",23,20,3,0,1
"ASF1A",26,25,1,0,1
"ASGR1",21,18,3,0,1
"HSP90AA1",83,66,17,0,1
"CREB1",535,116,419,0,1
"BATF3",6,5,1,0,1
"JUN",326,50,276,0,1
"DISC1",37,35,2,0,1
"LUC7L2",46,37,9,0,1
"RAD9A",19,17,2,0,1
"TOPBP1",25,22,3,0,1
"WRN",44,41,3,0,1
"XRCC5",53,48,5,0,1
"ATN1",47,30,17,0,1
"EWSR1",49,29,20,0,1
"SUMO2",28,23,5,0,1
"BCL2",70,60,10,0,1
"RASSF1",21,15,6,0,1
"CDK4",94,84,10,0,1
"PIN1",71,51,20,0,1
"ATR",20,15,5,0,1
"ATXN2",38,35,3,0,1
"COIL",63,55,8,0,1
"DAZAP2",79,74,5,0,1
"ATXN3",73,66,7,0,1
"PSMD7",20,18,2,0,1
"RAD23A",25,20,5,0,1
"RNF11",125,108,17,0,1
"AURKA",42,38,4,0,1
"CDC20",17,13,4,0,1
"NME1",22,18,4,0,1
"PPP1CC",64,61,3,0,1
"CTNNB1",107,85,22,0,1
"EEF1A1",57,43,14,0,1
"JUP",22,17,5,0,1
"SH3GL1",32,23,9,0,1
"CBL",123,95,28,0,1
"IL2RG",11,7,4,0,1
"LCK",66,35,31,0,1
"B2M",36,35,1,0,1
"RANBP9",28,24,4,0,1
"MAPK8",99,92,7,0,1
"PPP1CA",41,34,7,0,1
"YWHAQ",81,68,13,0,1
"SHANK1",11,2,9,0,1
"BAIAP2",16,10,6,0,1
"DIAPH1",61,59,2,0,1
"NCKIPSD",60,58,2,0,1
"IKBKAP",24,21,3,0,1
"CREB3L3",3,2,1,0,1
"MAP3K7",70,61,9,0,1
"FBLN2",27,23,4,0,1
"CASP1",18,12,6,0,1
"CASP8",61,38,23,0,1
"BCAR1",43,33,10,0,1
"CD2AP",74,70,4,0,1
"HCK",36,25,11,0,1
"TRIP6",20,14,6,0,1
"MAPK14",108,97,11,0,1
"BCL2A1",8,6,2,0,1
"GTF2A1",58,54,4,0,1
"NFKB2",70,11,59,0,1
"RUNX1T1",238,107,131,0,1
"ERCC3",11,10,1,0,1
"RBL1",55,50,5,0,1
"BMP4",11,9,2,0,1
"NEK9",71,70,1,0,1
"CASP7",26,19,7,0,1
"DIABLO",26,23,3,0,1
"UBB",56,37,19,0,1
"BLK",4,2,2,0,1
"CAMK2A",43,39,4,0,1
"RING1",15,12,3,0,1
"RNF2",36,33,3,0,1
"BMPR2",117,106,11,0,1
"BMX",7,6,1,0,1
"ITK",21,19,2,0,1
"BNIP3L",29,24,5,0,1
"RINT1",9,7,2,0,1
"MAP2K1",44,36,8,0,1
"BRCA2",18,14,4,0,1
"CDK2",83,76,7,0,1
"KPNA1",74,73,1,0,1
"NFYA",185,45,140,0,1
"BRD7",16,14,2,0,1
"RBL2",44,38,6,0,1
"BTK",46,9,37,0,1
"FAS",52,33,19,0,1
"KIT",73,46,27,0,1
"LYN",102,64,38,0,1
"MYD88",27,22,5,0,1
"PLCG2",84,68,16,0,1
"PRKCQ",15,9,6,0,1
"PRKCZ",39,18,21,0,1
"SYK",65,27,38,0,1
"VAV1",32,25,7,0,1
"SUFU",29,27,2,0,1
"UBQLN2",24,22,2,0,1
"PLK1",40,28,12,0,1
"KIAA1377",35,18,17,0,1
"RPLP1",46,39,7,0,1
"SF3B1",54,48,6,0,1
"C3",58,48,10,0,1
"LAMA1",19,11,8,0,1
"FGFR3",19,10,9,0,1
"C8orf33",30,28,2,0,1
"CABP2",2,1,1,0,1
"SKP1",36,33,3,0,1
"MPP3",7,6,1,0,1
"DMD",65,60,5,0,1
"CALCOCO2",33,27,6,0,1
"DAXX",17,13,4,0,1
"PIAS4",55,53,2,0,1
"LYST",25,22,3,0,1
"FBN1",76,70,6,0,1
"GABARAP",20,15,5,0,1
"THBS1",122,114,8,0,1
"TRAF6",70,40,30,0,1
"CAMLG",25,21,4,0,1
"EBI3",17,16,1,0,1
"CAPN1",21,17,4,0,1
"CAPNS1",24,20,4,0,1
"CAPRIN1",60,59,1,0,1
"RPP14",57,56,1,0,1
"TRAF1",63,51,12,0,1
"CASK",55,42,13,0,1
"GRIN2A",86,79,7,0,1
"PRKD2",30,26,4,0,1
"PLA2G4A",42,34,8,0,1
"CASP10",39,37,2,0,1
"DSP",30,29,1,0,1
"CASP6",7,6,1,0,1
"EIF2AK2",57,44,13,0,1
"IL16",22,17,5,0,1
"KRT18",31,21,10,0,1
"TOP1",33,31,2,0,1
"RIPK1",17,13,4,0,1
"PPFIA1",22,19,3,0,1
"HRAS",51,28,23,0,1
"ILK",38,29,9,0,1
"TRPC1",14,12,2,0,1
"CD5",17,14,3,0,1
"INSR",78,52,26,0,1
"ITCH",36,33,3,0,1
"CBX3",54,53,1,0,1
"TRIM28",48,45,3,0,1
"CTBP2",36,35,1,0,1
"MED9",17,12,5,0,1
"MCM10",28,20,8,0,1
"CCR5",42,33,9,0,1
"MMP3",14,11,3,0,1
"CCR10",11,10,1,0,1
"CXCL13",9,7,2,0,1
"CCL2",20,15,5,0,1
"CCR1",10,8,2,0,1
"MMP1",11,9,2,0,1
"VCAN",73,63,10,0,1
"GOT2",26,24,2,0,1
"DPP4",18,11,7,0,1
"CCL3",12,11,1,0,1
"CCR3",10,5,5,0,1
"IL8",18,17,1,0,1
"CDK7",13,10,3,0,1
"DVL3",61,56,5,0,1
"CDK9",47,39,8,0,1
"JAK1",79,54,25,0,1
"JAK2",59,35,24,0,1
"CD4",48,35,13,0,1
"PTK2B",31,16,15,0,1
"SOD1",10,9,1,0,1
"ITGB2",24,11,13,0,1
"ITGB1",97,70,27,0,1
"CD79A",11,7,4,0,1
"LCP2",28,19,9,0,1
"LAT",18,9,9,0,1
"CD247",19,6,13,0,1
"CSK",33,27,6,0,1
"TRAF3",31,29,2,0,1
"CD28",46,34,12,0,1
"GRAP2",58,49,9,0,1
"PIK3CG",32,26,6,0,1
"PTK2",58,36,22,0,1
"GNAI1",46,32,14,0,1
"ITGAV",48,40,8,0,1
"SIRPA",34,31,3,0,1
"UBQLN1",48,40,8,0,1
"SDCBP",54,46,8,0,1
"CTLA4",14,12,2,0,1
"CD81",31,26,5,0,1
"ITGA4",26,21,5,0,1
"COL4A3",33,28,5,0,1
"SAFB",26,21,5,0,1
"CDH2",44,39,5,0,1
"CTNND1",62,59,3,0,1
"CDH5",30,24,6,0,1
"NOL12",13,12,1,0,1
"CDK5RAP1",8,6,2,0,1
"SHC1",37,29,8,0,1
"GATA2",157,15,142,0,1
"SOX8",12,8,4,0,1
"SMARCC1",41,33,8,0,1
"SPTBN4",23,20,3,0,1
"NR5A2",40,34,6,0,1
"NEK2",9,7,2,0,1
"LIMK1",25,23,2,0,1
"PRKG1",61,48,13,0,1
"SLC9A3R2",33,26,7,0,1
"PML",13,11,2,0,1
"POLR2E",32,28,4,0,1
"CHM",13,12,1,0,1
"RAB1A",46,44,2,0,1
"CHMP1B",34,32,2,0,1
"CHMP2A",11,9,2,0,1
"WWP1",31,27,4,0,1
"HGS",40,23,17,0,1
"LRP2",14,11,3,0,1
"CNKSR1",6,4,2,0,1
"CNOT7",35,32,3,0,1
"MET",70,50,20,0,1
"IL6ST",81,79,2,0,1
"PTPRB",29,26,3,0,1
"TAF9",16,10,6,0,1
"KDR",54,33,21,0,1
"DCN",24,15,9,0,1
"IGFBP3",42,37,5,0,1
"XRN2",21,16,5,0,1
"TRIM37",45,40,5,0,1
"GPS1",23,17,6,0,1
"STX5",17,16,1,0,1
"COPS7A",19,15,4,0,1
"NFIL3",17,16,1,0,1
"EBF1",317,46,271,0,1
"ETS1",392,87,305,0,1
"H3F3A",13,12,1,0,1
"MAFG",47,42,5,0,1
"NCOA6",42,35,7,0,1
"PROX1",80,65,15,0,1
"SNIP1",47,44,3,0,1
"GNAQ",70,53,17,0,1
"TUBB2A",77,75,2,0,1
"IRS2",41,35,6,0,1
"CRKL",121,100,21,0,1
"PXN",50,30,20,0,1
"EEF1D",57,52,5,0,1
"UBE2A",24,22,2,0,1
"INPP5D",16,9,7,0,1
"CSF2",4,3,1,0,1
"CSF2RB",19,9,10,0,1
"HNRNPK",44,34,10,0,1
"ERCC8",14,12,2,0,1
"POLR2B",22,21,1,0,1
"CTGF",51,49,2,0,1
"NOV",16,12,4,0,1
"ZFYVE9",41,36,5,0,1
"ERBB2IP",46,44,2,0,1
"CTSD",11,8,3,0,1
"LGALS3",16,12,4,0,1
"NCF4",5,4,1,0,1
"CYCS",54,52,2,0,1
"FMR1",45,43,2,0,1
"TRIM23",36,32,4,0,1
"DAG1",46,42,4,0,1
"HDAC1",30,19,11,0,1
"MCM3",34,28,6,0,1
"MCM7",53,46,7,0,1
"SF1",50,48,2,0,1
"POLA2",39,36,3,0,1
"DEK",61,59,2,0,1
"SRRM1",16,13,3,0,1
"PTCH1",40,39,1,0,1
"DIAPH2",45,44,1,0,1
"DLG1",54,25,29,0,1
"GNG13",6,5,1,0,1
"KCNA2",13,10,3,0,1
"DLG2",53,37,16,0,1
"NOS1",17,13,4,0,1
"DLG4",22,12,10,0,1
"FLII",15,12,3,0,1
"SOX10",28,11,17,0,1
"KRT8",39,30,9,0,1
"RPS10",14,12,2,0,1
"HSPA1B",62,61,1,0,1
"PPP2CB",18,17,1,0,1
"KIAA1279",28,24,4,0,1
"VTA1",56,51,5,0,1
"NCK1",62,23,39,0,1
"DUSP23",13,8,5,0,1
"PNN",22,17,5,0,1
"PARD3",43,37,6,0,1
"MYO5A",61,59,2,0,1
"MBP",29,11,18,0,1
"E2F3",169,100,69,0,1
"TFDP1",25,22,3,0,1
"ECH1",11,8,3,0,1
"FURIN",34,33,1,0,1
"EDN3",11,10,1,0,1
"GNA11",14,12,2,0,1
"EXOSC4",17,9,8,0,1
"IMMT",23,16,7,0,1
"EFNA1",51,49,2,0,1
"EFNA3",22,21,1,0,1
"HOMER1",48,41,7,0,1
"PTPN13",26,21,5,0,1
"GOLM1",20,19,1,0,1
"SNRPD2",19,11,8,0,1
"TRIM27",30,28,2,0,1
"UPF2",34,25,9,0,1
"EIF3L",21,20,1,0,1
"EIF3E",17,12,5,0,1
"GADD45G",21,13,8,0,1
"SMN1",20,8,12,0,1
"MVD",8,7,1,0,1
"FUNDC2",23,22,1,0,1
"RPL6",8,7,1,0,1
"ID2",33,28,5,0,1
"EMD",23,20,3,0,1
"NMI",12,11,1,0,1
"ING4",10,8,2,0,1
"SYNCRIP",92,90,2,0,1
"ERG",613,37,576,0,1
"FLI1",462,31,431,0,1
"PIK3CB",44,36,8,0,1
"ETF1",54,53,1,0,1
"GATA3",444,26,418,0,1
"EXOSC6",25,18,7,0,1
"RAB27A",37,30,7,0,1
"F10",10,8,2,0,1
"SGTA",19,14,5,0,1
"TJP1",61,51,10,0,1
"UFD1L",13,12,1,0,1
"F2R",40,35,5,0,1
"RAP1A",73,59,14,0,1
"RABAC1",50,39,11,0,1
"TNFRSF1A",28,15,13,0,1
"FCER1G",10,4,6,0,1
"ZAP70",29,5,24,0,1
"FEZ1",18,6,12,0,1
"RPS6KA3",111,102,9,0,1
"FIGF",6,4,2,0,1
"GATA1",407,4,403,0,1
"SHBG",5,2,3,0,1
"KRAS",64,58,6,0,1
"PTPRF",56,52,4,0,1
"MAPK8IP2",36,27,9,0,1
"TAF10",21,12,9,0,1
"SNAP23",46,39,7,0,1
"GIPC1",32,25,7,0,1
"LRP6",60,55,5,0,1
"RYK",29,28,1,0,1
"FZD9",35,33,2,0,1
"PPP3CA",47,39,8,0,1
"TRAK2",29,28,1,0,1
"IARS",25,24,1,0,1
"ZFPM1",20,18,2,0,1
"NR5A1",5,3,2,0,1
"MBD3",375,37,338,0,1
"GBP2",18,11,7,0,1
"NCAM1",19,15,4,0,1
"PDLIM7",18,14,4,0,1
"RGS19",21,15,6,0,1
"PSD",18,17,1,0,1
"HTR2A",39,31,8,0,1
"RGS4",26,25,1,0,1
"GNAI3",55,46,9,0,1
"PLCB1",41,37,4,0,1
"PABPC1",48,40,8,0,1
"NUDT18",17,11,6,0,1
"GOLGA2",38,31,7,0,1
"IGF2",56,52,4,0,1
"LRSAM1",15,11,4,0,1
"GPRASP2",17,9,8,0,1
"GRASP",10,7,3,0,1
"USP8",30,28,2,0,1
"GRIK2",16,15,1,0,1
"MAP2K2",23,17,6,0,1
"PPM1A",66,62,4,0,1
"IGSF21",7,5,2,0,1
"KIF5B",70,68,2,0,1
"NSFL1C",20,19,1,0,1
"RAC1",69,58,11,0,1
"TAF1C",7,4,3,0,1
"HAND2",96,43,53,0,1
"TCF3",439,25,414,0,1
"MMP7",13,5,8,0,1
"HBEGF",30,27,3,0,1
"HCST",3,2,1,0,1
"HDAC3",20,14,6,0,1
"TARBP2",27,25,2,0,1
"NR4A1",47,17,30,0,1
"HEXDC",5,3,2,0,1
"SMAD7",69,59,10,0,1
"PLAU",17,13,4,0,1
"NR1H2",52,10,42,0,1
"MEIS1",48,40,8,0,1
"HOXC8",60,58,2,0,1
"SMAD6",35,32,3,0,1
"RHOD",6,2,4,0,1
"NUAK1",50,45,5,0,1
"VDAC1",15,11,4,0,1
"MSC",12,10,2,0,1
"IFNAR1",60,51,9,0,1
"IGF1",113,112,1,0,1
"IL12B",10,9,1,0,1
"TICAM2",17,11,6,0,1
"IRAK1",53,32,21,0,1
"NGFR",43,33,10,0,1
"IL21",2,1,1,0,1
"SDC1",35,28,7,0,1
"LIMS1",65,60,5,0,1
"RNF19A",40,32,8,0,1
"IRF3",34,15,19,0,1
"TLN1",87,80,7,0,1
"ITGB5",18,10,8,0,1
"VTN",9,4,5,0,1
"ITPR1",35,28,7,0,1
"RPS6KA5",66,61,5,0,1
"PTPN6",51,10,41,0,1
"SNAP25",38,37,1,0,1
"KCNJ10",22,20,2,0,1
"KISS1",3,2,1,0,1
"KLRD1",32,31,1,0,1
"TYROBP",6,4,2,0,1
"KTN1",29,27,2,0,1
"LEF1",37,22,15,0,1
"LEPR",29,18,11,0,1
"TMPO",40,36,4,0,1
"SHANK2",30,27,3,0,1
"LSM2",10,5,5,0,1
"LSM4",25,20,5,0,1
"LSM5",16,12,4,0,1
"LTA",4,2,2,0,1
"TNFRSF14",15,9,6,0,1
"LTB",12,10,2,0,1
"TRAF2",90,21,69,0,1
"PTCD3",24,23,1,0,1
"ZHX1",53,45,8,0,1
"WIPF1",35,32,3,0,1
"MED12",19,17,2,0,1
"PIK3R2",11,8,3,0,1
"MAPK8IP3",30,24,6,0,1
"TTF2",46,38,8,0,1
"ZNF512B",85,77,8,0,1
"RPL18A",25,22,3,0,1
"MEF2A",116,52,64,0,1
"TCAP",6,2,4,0,1
"OSGEP",11,3,8,0,1
"RAB11A",47,46,1,0,1
"NR1D2",44,42,2,0,1
"NEDD8",15,8,7,0,1
"PSMD4",11,9,2,0,1
"NFIX",55,54,1,0,1
"NFIB",126,125,1,0,1
"NTRK1",8,1,7,0,1
"NHP2L1",24,23,1,0,1
"SFPQ",118,33,85,0,1
"VDR",77,24,53,0,1
"STX4",47,41,6,0,1
"NTS",3,2,1,0,1
"PIM1",44,42,2,0,1
"NUP98",50,44,6,0,1
"TNNI3",5,3,2,0,1
"BACH2",107,87,20,0,1
"E2F6",220,14,206,0,1
"PDCD10",37,36,1,0,1
"PDCD6IP",39,29,10,0,1
"RAD50",26,22,4,0,1
"PDGFRB",47,21,26,0,1
"PEX5",16,14,2,0,1
"PFN2",56,54,2,0,1
"TRPC3",24,18,6,0,1
"POLR3F",19,17,2,0,1
"WBP11",26,22,4,0,1
"PPP1R9B",34,31,3,0,1
"PSMA1",9,6,3,0,1
"PTGDS",6,4,2,0,1
"PTGFR",22,20,2,0,1
"TUBB2B",17,11,6,0,1
"RAB10",68,67,1,0,1
"RAB3IL1",8,7,1,0,1
"RABGGTB",14,13,1,0,1
"VAMP2",25,22,3,0,1
"UTP14A",17,14,3,0,1
"RNF216",34,32,2,0,1
"RTN4R",9,7,2,0,1
"RUVBL1",9,8,1,0,1
"SCARB1",24,23,1,0,1
"TNFSF13",8,6,2,0,1
"SERPINE1",45,40,5,0,1
"SMAD5",100,90,10,0,1
"SH3GL3",6,1,5,0,1
"SIX5",123,35,88,0,1
"STRN4",30,26,4,0,1
"SOX5",66,64,2,0,1
"SMG5",16,15,1,0,1
"UPF1",26,20,6,0,1
"TCEB1",40,38,2,0,1
"SOX6",63,61,2,0,1
"STAT3",409,66,343,0,1
"STC2",42,41,1,0,1
"TNFRSF10B",73,68,5,0,1
"TNFRSF13C",73,71,2,0,1
"TNFRSF4",5,1,4,0,1
"TRIM5",21,20,1,0,1
"ZBTB43",68,67,1,0,1
"ZNF417",45,43,2,0,1
"ZNF446",28,26,2,0,1
"JARID2",121,44,77,0,1
"ZBTB7A",293,108,185,0,1
"hsa-miR-130a-5p",991,36,955,0,1
"hsa-miR-133a-5p",60,19,41,0,1
"hsa-miR-135a-5p",237,9,228,0,1
"hsa-miR-145-5p",587,54,533,0,1
"hsa-miR-146a-5p",327,66,261,0,1
"hsa-miR-155-5p",509,57,452,0,1
"hsa-miR-196b-5p",388,34,354,0,1
"hsa-miR-206",182,6,176,0,1
"hsa-miR-21-5p",586,91,495,0,1
"hsa-miR-215-5p",211,22,189,0,1
"hsa-miR-223-5p",222,33,189,0,1
"hsa-miR-29b-2-5p",82,65,17,0,1
"hsa-miR-338-5p",388,29,359,0,1
"hsa-miR-342-5p",360,45,315,0,1
"hsa-miR-3648",86,81,5,0,1
"hsa-miR-4473",43,32,11,0,1
"hsa-miR-4503",33,23,10,0,1
