"Name","K","Kin","Kout","TypeI","TypeII"
"ANXA7",82,61,21,0,1
"SYNCRIP",90,88,2,0,1
"A2M",26,8,18,0,1
"ATF7IP",81,58,23,0,1
"CDKN1A",120,101,19,0,1
"H2AFX",44,38,6,0,1
"HMOX2",23,11,12,0,1
"KLK2",22,21,1,0,1
"KLK3",10,4,6,0,1
"NUDT21",41,31,10,0,1
"SMN1",70,29,41,0,1
"TGFBI",16,13,3,0,1
"TK1",123,89,34,0,1
"MAP1LC3B",33,28,5,0,1
"MDFI",66,56,10,0,1
"RB1",145,121,24,0,1
"ABCA1",48,40,8,0,1
"CSNK2A1",138,109,29,0,1
"FADD",26,14,12,0,1
"MPP6",46,41,5,0,1
"RDX",56,50,6,0,1
"STX1A",24,15,9,0,1
"ABL1",91,51,40,0,1
"HSPA8",79,56,23,0,1
"MINK1",53,48,5,0,1
"NCK2",39,29,10,0,1
"SOS1",65,45,20,0,1
"SOS2",22,18,4,0,1
"WASF1",26,22,4,0,1
"KRT15",33,29,4,0,1
"ATM",38,20,18,0,1
"BCAR1",44,33,11,0,1
"CASP9",37,27,10,0,1
"CAV1",103,68,35,0,1
"CDK5",32,24,8,0,1
"CRK",94,67,27,0,1
"MAPT",58,45,13,0,1
"MDM2",123,111,12,0,1
"POLR2A",78,66,12,0,1
"PRKD1",32,25,7,0,1
"PRKDC",64,55,9,0,1
"PTPN12",42,39,3,0,1
"RAD51",88,81,7,0,1
"RAD52",10,8,2,0,1
"RAN",88,75,13,0,1
"SFN",19,14,5,0,1
"XRCC6",62,42,20,0,1
"YWHAE",77,58,19,0,1
"YWHAG",233,185,48,0,1
"YWHAZ",197,134,63,0,1
"ABL2",51,48,3,0,1
"ATXN1",160,128,32,0,1
"USP7",41,37,4,0,1
"ACP1",29,23,6,0,1
"CTNNB1",101,77,24,0,1
"FYN",162,91,71,0,1
"INSR",75,42,33,0,1
"SPTAN1",28,17,11,0,1
"PPP2CB",22,21,1,0,1
"CFL1",23,17,6,0,1
"GSN",30,22,8,0,1
"MYLK",65,60,5,0,1
"PFN1",52,39,13,0,1
"PRKCE",51,40,11,0,1
"S100A4",7,5,2,0,1
"VCL",120,84,36,0,1
"ACTB",128,97,31,0,1
"BCL2L1",72,62,10,0,1
"CSNK1A1",93,82,11,0,1
"EMD",21,17,4,0,1
"PFDN1",27,19,8,0,1
"RCC1",40,32,8,0,1
"ACTC1",18,8,10,0,1
"ACTN4",43,34,9,0,1
"DMD",57,52,5,0,1
"DYNLL1",43,31,12,0,1
"MAPK6",126,86,40,0,1
"PDPK1",96,83,13,0,1
"PFN2",56,49,7,0,1
"PIP4K2C",35,29,6,0,1
"PLD1",27,23,4,0,1
"RPS6KA5",68,60,8,0,1
"SH3GL2",14,10,4,0,1
"ACTN1",49,37,12,0,1
"COIL",52,45,7,0,1
"PKN1",24,20,4,0,1
"ACTN2",18,12,6,0,1
"CAMK2A",36,28,8,0,1
"DCTN1",19,13,6,0,1
"CHD3",66,49,17,0,1
"CDC42",73,44,29,0,1
"CTTN",24,20,4,0,1
"ACVR1",76,52,24,0,1
"AP2B1",56,45,11,0,1
"IKBKB",44,34,10,0,1
"RAB17",17,13,4,0,1
"RAP2A",40,32,8,0,1
"STX8",11,9,2,0,1
"ACVR1B",59,53,6,0,1
"TGFBRAP1",16,13,3,0,1
"ACVR2A",46,44,2,0,1
"SYNJ2BP",46,42,4,0,1
"TGFB1",35,23,12,0,1
"TGFBR1",128,77,51,0,1
"TGFBR2",107,91,16,0,1
"GRB2",133,67,66,0,1
"SH3D19",52,50,2,0,1
"TGFA",35,31,4,0,1
"ADAM15",13,12,1,0,1
"MAD2L1",28,23,5,0,1
"NOTCH1",52,46,6,0,1
"TNFSF11",26,15,11,0,1
"RYR1",16,7,9,0,1
"MAD2L2",8,4,4,0,1
"PRKCD",67,43,24,0,1
"FN1",94,76,18,0,1
"PRKCA",145,75,70,0,1
"RAF1",73,45,28,0,1
"CALM1",95,72,23,0,1
"APPL1",36,29,7,0,1
"CFH",10,8,2,0,1
"ADORA1",6,3,3,0,1
"GNAZ",8,5,3,0,1
"GRM1",11,6,5,0,1
"CYTH2",28,22,6,0,1
"SLC9A3R2",41,34,7,0,1
"FLNC",27,20,7,0,1
"RGS2",34,13,21,0,1
"EIF2B1",15,12,3,0,1
"GNAI2",62,55,7,0,1
"GNAO1",19,9,10,0,1
"DLG4",76,33,43,0,1
"GIPC1",29,20,9,0,1
"ADRB2",30,16,14,0,1
"ARR3",8,4,4,0,1
"ARRB1",59,38,21,0,1
"CSK",38,29,9,0,1
"GNA11",23,18,5,0,1
"GPRASP1",31,11,20,0,1
"GRK5",32,23,9,0,1
"SLC9A3R1",44,24,20,0,1
"SRC",104,49,55,0,1
"ADRBK1",35,20,15,0,1
"CAPN2",14,8,6,0,1
"CSNK2B",77,30,47,0,1
"GIT1",49,34,15,0,1
"MAPK3",70,60,10,0,1
"PEBP1",31,29,2,0,1
"PRKCB",49,34,15,0,1
"ADRBK2",37,35,2,0,1
"CXCR4",24,14,10,0,1
"GTF2E1",20,19,1,0,1
"HMGB1",61,59,2,0,1
"PRKCZ",49,24,25,0,1
"ATXN1L",71,59,12,0,1
"AFF1",65,55,10,0,1
"SIAH2",24,22,2,0,1
"SGSM2",28,21,7,0,1
"UBE3A",55,49,6,0,1
"AGAP2",9,8,1,0,1
"AGFG1",49,45,4,0,1
"CCDC85B",90,74,16,0,1
"BRD7",37,33,4,0,1
"CCDC90B",16,13,3,0,1
"MED31",30,25,5,0,1
"EWSR1",64,35,29,0,1
"ARRB2",40,22,18,0,1
"EGFR",158,99,59,0,1
"HRAS",54,30,24,0,1
"JAK2",67,29,38,0,1
"AHR",75,44,31,0,1
"ARNT",40,20,20,0,1
"EP300",179,155,24,0,1
"NCOA1",99,63,36,0,1
"NCOA2",67,51,16,0,1
"SMARCA4",46,28,18,0,1
"AIP",11,10,1,0,1
"AK5",5,4,1,0,1
"PRKAR2A",45,38,7,0,1
"AKAP10",28,23,5,0,1
"PRKAR1A",59,41,18,0,1
"GSK3B",141,96,45,0,1
"YWHAB",114,81,33,0,1
"KPNB1",84,67,17,0,1
"PRPF40A",74,55,19,0,1
"AKAP9",40,36,4,0,1
"AKT1",83,50,33,0,1
"CHUK",53,35,18,0,1
"HSP90AB1",49,44,5,0,1
"HTT",68,52,16,0,1
"BCL2A1",6,4,2,0,1
"HSP90AA1",99,70,29,0,1
"IMMT",37,21,16,0,1
"LUC7L2",45,36,9,0,1
"IGSF21",17,11,6,0,1
"XRN1",51,45,6,0,1
"PTN",49,17,32,0,1
"CRMP1",47,22,25,0,1
"AMOTL2",38,36,2,0,1
"CLTC",93,78,15,0,1
"DNM1",27,19,8,0,1
"TEK",18,8,10,0,1
"ANK3",20,18,2,0,1
"HDAC4",47,42,5,0,1
"LRP2",29,13,16,0,1
"ANXA1",21,12,9,0,1
"COPS6",59,38,21,0,1
"TGM2",24,13,11,0,1
"UNC119",54,24,30,0,1
"ANXA11",30,27,3,0,1
"PLSCR1",61,36,25,0,1
"S100A6",5,4,1,0,1
"EED",39,35,4,0,1
"C14orf1",33,23,10,0,1
"VIM",105,73,32,0,1
"DVL2",31,20,11,0,1
"FXR2",36,24,12,0,1
"AP1S1",22,20,2,0,1
"AP2A1",30,22,8,0,1
"BIN1",19,13,6,0,1
"RIT1",12,10,2,0,1
"AP2M1",36,32,4,0,1
"MEGF10",11,8,3,0,1
"AP3B1",38,33,5,0,1
"ARF1",41,29,12,0,1
"XPOT",57,54,3,0,1
"TGOLN2",56,52,4,0,1
"CASP3",127,71,56,0,1
"HSPA1A",49,36,13,0,1
"APP",93,63,30,0,1
"APLP2",21,20,1,0,1
"SIAH1",29,26,3,0,1
"COL4A1",34,28,6,0,1
"HDAC1",73,56,17,0,1
"PCNA",82,71,11,0,1
"UBE2I",80,67,13,0,1
"CALCOCO2",37,30,7,0,1
"APLP1",22,15,7,0,1
"SETDB1",67,53,14,0,1
"APOA1",17,7,10,0,1
"TTR",11,7,4,0,1
"APOA2",2,1,1,0,1
"APOB",12,5,7,0,1
"KPNA2",77,72,5,0,1
"LRP1",55,39,16,0,1
"PLG",7,5,2,0,1
"COL4A2",36,30,6,0,1
"HSPG2",35,28,7,0,1
"PSEN2",20,12,8,0,1
"SHC1",79,48,31,0,1
"SNCA",31,16,15,0,1
"TP53BP2",40,35,5,0,1
"APPBP2",41,39,2,0,1
"PIK3CA",42,31,11,0,1
"APTX",19,16,3,0,1
"EFEMP2",24,18,6,0,1
"TRIP6",27,18,9,0,1
"AR",557,71,486,0,1
"CDC37",50,43,7,0,1
"CDK7",14,12,2,0,1
"CREBBP",267,94,173,0,1
"GTF2H1",29,22,7,0,1
"MED1",46,40,6,0,1
"NCOR2",94,56,38,0,1
"NFKB1",125,33,92,0,1
"NR5A1",13,7,6,0,1
"PIAS4",47,42,5,0,1
"POU2F1",110,96,14,0,1
"RNF4",33,32,1,0,1
"SMAD1",117,27,90,0,1
"SMAD3",163,53,110,0,1
"SP1",343,104,239,0,1
"SUMO1",68,61,7,0,1
"TRIM24",44,34,10,0,1
"ARIH2",22,20,2,0,1
"ARPC3",19,15,4,0,1
"PICK1",26,10,16,0,1
"HMGCR",28,27,1,0,1
"ITPR1",45,34,11,0,1
"PIK3R1",144,87,57,0,1
"PTPN11",101,53,48,0,1
"RASA1",81,53,28,0,1
"RHOA",59,39,20,0,1
"TUBA4A",31,18,13,0,1
"MAGEA11",9,6,3,0,1
"PTPN18",4,3,1,0,1
"SMURF2",71,48,23,0,1
"RBPMS",36,33,3,0,1
"EZR",29,21,8,0,1
"VAV1",47,31,16,0,1
"ARHGEF11",14,9,5,0,1
"GNA12",33,21,12,0,1
"GNA13",58,43,15,0,1
"MAP1B",87,77,10,0,1
"PLXNB3",6,1,5,0,1
"ARHGEF12",43,37,6,0,1
"CD44",28,13,15,0,1
"IGF1R",152,132,20,0,1
"ARHGEF7",24,16,8,0,1
"CBLB",44,34,10,0,1
"SMARCE1",22,15,7,0,1
"E2F1",501,54,447,0,1
"E2F2",98,83,15,0,1
"SIN3A",61,54,7,0,1
"UBE2L3",20,16,4,0,1
"CBR3",3,2,1,0,1
"GAPDH",69,48,21,0,1
"RPL8",16,12,4,0,1
"UBR1",35,22,13,0,1
"ARL4D",22,20,2,0,1
"ATP5J2",13,10,3,0,1
"WAS",28,13,15,0,1
"PRMT1",33,20,13,0,1
"RNF130",11,9,2,0,1
"BMPR2",84,70,14,0,1
"CD2AP",68,63,5,0,1
"CSNK2A2",46,29,17,0,1
"FLNA",72,53,19,0,1
"HIPK3",76,70,6,0,1
"MAPK1",157,127,30,0,1
"MED8",47,41,6,0,1
"PDE4D",40,39,1,0,1
"STC2",55,50,5,0,1
"HCK",55,36,19,0,1
"SH3KBP1",55,52,3,0,1
"H3F3A",13,12,1,0,1
"ASGR1",16,12,4,0,1
"ASIP",4,3,1,0,1
"F11R",23,18,5,0,1
"CREB1",220,54,166,0,1
"GABPA",95,15,80,0,1
"GABPB1",65,58,7,0,1
"SPI1",193,18,175,0,1
"CEBPG",47,40,7,0,1
"HMGA1",78,66,12,0,1
"JUN",316,59,257,0,1
"GPS2",10,5,5,0,1
"CDC34",21,19,2,0,1
"DISC1",30,27,3,0,1
"EIF4EBP1",49,43,6,0,1
"STK11",37,32,5,0,1
"TOPBP1",26,22,4,0,1
"WRN",20,17,3,0,1
"ATN1",59,36,23,0,1
"CBFA2T2",25,23,2,0,1
"DMPK",30,25,5,0,1
"BCL2",97,79,18,0,1
"CSE1L",52,50,2,0,1
"RASSF1",21,13,8,0,1
"ATP5C1",24,21,3,0,1
"PSME3",51,44,7,0,1
"RPP14",25,23,2,0,1
"ATR",21,14,7,0,1
"XPA",11,8,3,0,1
"EZH2",291,33,258,0,1
"CCNK",25,17,8,0,1
"DAZAP2",103,93,10,0,1
"FAM46A",27,25,2,0,1
"GSPT1",61,58,3,0,1
"PSMC3",11,7,4,0,1
"U2AF2",26,22,4,0,1
"CTBP2",23,20,3,0,1
"RAD23A",19,13,6,0,1
"RNF11",84,64,20,0,1
"CDC20",22,18,4,0,1
"NME1",22,17,5,0,1
"PPP1CA",36,30,6,0,1
"PPP1CC",50,47,3,0,1
"AVP",6,4,2,0,1
"C1QTNF1",6,4,2,0,1
"GNAS",46,38,8,0,1
"AXIN1",39,18,21,0,1
"BTRC",71,58,13,0,1
"DVL1",24,18,6,0,1
"EEF1A1",74,48,26,0,1
"JUP",26,19,7,0,1
"PPP2CA",83,70,13,0,1
"SH3GL1",27,19,8,0,1
"UTP14A",29,20,9,0,1
"AXL",42,29,13,0,1
"CBL",110,76,34,0,1
"IL2RG",16,9,7,0,1
"LCK",74,36,38,0,1
"PIK3R2",32,21,11,0,1
"PIK3R3",47,41,6,0,1
"B2M",28,26,2,0,1
"HLA-A",30,20,10,0,1
"PSEN1",50,31,19,0,1
"RANBP9",29,23,6,0,1
"MAPK8",71,63,8,0,1
"SUMO2",52,43,9,0,1
"YWHAQ",95,79,16,0,1
"KRTAP4-12",11,4,7,0,1
"PHYHIP",45,34,11,0,1
"SHANK1",14,4,10,0,1
"STARD13",40,36,4,0,1
"IKBKAP",27,23,4,0,1
"NFIL3",23,21,2,0,1
"CREB3L3",5,2,3,0,1
"BID",44,35,9,0,1
"PMAIP1",25,21,4,0,1
"VDAC1",27,21,6,0,1
"HDAC6",13,10,3,0,1
"MAP3K7",61,52,9,0,1
"CASP8",52,27,25,0,1
"CDK2",100,91,9,0,1
"CYCS",73,71,2,0,1
"SOD1",10,9,1,0,1
"BCL3",49,15,34,0,1
"HDAC3",39,29,10,0,1
"NFKB2",57,12,45,0,1
"ZBTB7A",330,115,215,0,1
"ERCC3",18,14,4,0,1
"GNAQ",64,46,18,0,1
"GRK6",28,23,5,0,1
"CPE",44,37,7,0,1
"DTNB",13,10,3,0,1
"RBL1",68,63,5,0,1
"BMP4",15,8,7,0,1
"CASP10",27,25,2,0,1
"DNM2",48,31,17,0,1
"BIRC2",29,15,14,0,1
"CASP7",28,21,7,0,1
"DIABLO",22,18,4,0,1
"TRAF1",65,45,20,0,1
"UBB",41,24,17,0,1
"BLK",6,3,3,0,1
"BLNK",20,14,6,0,1
"BMI1",43,39,4,0,1
"RING1",15,12,3,0,1
"RNF2",30,26,4,0,1
"ZFYVE9",31,22,9,0,1
"GDF9",23,5,18,0,1
"TNNT1",24,12,12,0,1
"TUBB",83,66,17,0,1
"ITK",20,17,3,0,1
"PTK2",81,48,33,0,1
"RINT1",12,9,3,0,1
"ROBO2",39,31,8,0,1
"MAP2K1",49,35,14,0,1
"BRCA2",21,16,5,0,1
"KPNA1",61,57,4,0,1
"NFYA",218,48,170,0,1
"NMI",16,15,1,0,1
"RFC1",25,21,4,0,1
"UBE2D3",42,39,3,0,1
"RBL2",42,36,6,0,1
"RBP1",12,8,4,0,1
"PDLIM7",20,14,6,0,1
"TRIM5",12,10,2,0,1
"BTK",49,8,41,0,1
"KHDRBS1",39,34,5,0,1
"KIT",61,31,30,0,1
"LYN",117,71,46,0,1
"MYD88",29,19,10,0,1
"PLCG2",74,53,21,0,1
"PRKCQ",19,8,11,0,1
"SYK",67,24,43,0,1
"TNFRSF14",24,14,10,0,1
"SKP1",49,42,7,0,1
"BUB1",40,35,5,0,1
"PLK1",66,41,25,0,1
"BUB1B",11,9,2,0,1
"C11orf58",26,20,6,0,1
"KIAA1377",61,26,35,0,1
"SF3B1",33,27,6,0,1
"HNRNPUL1",44,41,3,0,1
"C19orf57",7,6,1,0,1
"TSNAX",20,18,2,0,1
"GOLM1",27,24,3,0,1
"DCN",25,15,10,0,1
"C1QBP",23,20,3,0,1
"SGTA",14,8,6,0,1
"UBQLN4",75,37,38,0,1
"CTSG",16,7,9,0,1
"C5",5,3,2,0,1
"C6",7,6,1,0,1
"FGFR3",28,15,13,0,1
"C8orf33",41,34,7,0,1
"FEZ1",26,9,17,0,1
"CACHD1",17,15,2,0,1
"XAB2",8,3,5,0,1
"PPM1A",63,56,7,0,1
"MPP3",10,9,1,0,1
"CALCA",2,1,1,0,1
"GABARAPL2",11,10,1,0,1
"GPRASP2",24,10,14,0,1
"LYST",22,19,3,0,1
"STRN4",28,21,7,0,1
"TTN",16,8,8,0,1
"CALR",77,59,18,0,1
"PLAT",24,21,3,0,1
"THBS1",92,80,12,0,1
"TRAF6",62,26,36,0,1
"CAMK1",5,2,3,0,1
"KRT18",35,25,10,0,1
"CAMLG",26,21,5,0,1
"PRTN3",7,6,1,0,1
"EBI3",10,9,1,0,1
"CAPN1",17,9,8,0,1
"CAPNS1",17,11,6,0,1
"RAB1A",42,40,2,0,1
"CAPRIN1",44,43,1,0,1
"TSC22D1",46,41,5,0,1
"CASK",47,29,18,0,1
"CNTNAP2",22,18,4,0,1
"GRIN2A",56,49,7,0,1
"PRKD2",26,22,4,0,1
"PLA2G4A",33,23,10,0,1
"CASP2",48,40,8,0,1
"DSP",24,23,1,0,1
"EIF2AK2",62,46,16,0,1
"PTMA",58,40,18,0,1
"ROCK1",44,39,5,0,1
"STK4",58,57,1,0,1
"TOP1",29,27,2,0,1
"RIPK1",22,16,6,0,1
"RYBP",73,70,3,0,1
"RNF19A",31,23,8,0,1
"SUMO4",27,9,18,0,1
"ILK",34,24,10,0,1
"IRS1",82,63,19,0,1
"PTEN",75,69,6,0,1
"PTPRF",37,32,5,0,1
"DNAJA1",45,38,7,0,1
"CBFA2T3",33,32,1,0,1
"CD5",17,14,3,0,1
"ITCH",23,20,3,0,1
"SH3GL3",25,8,17,0,1
"SPRY2",29,24,5,0,1
"CBX2",55,54,1,0,1
"MED9",17,12,5,0,1
"MCM10",35,26,9,0,1
"CCR5",40,29,11,0,1
"HNRNPH3",20,16,4,0,1
"MMP3",13,10,3,0,1
"VCAM1",31,28,3,0,1
"CCR10",11,8,3,0,1
"CXCL13",9,7,2,0,1
"CCR1",10,8,2,0,1
"VCAN",62,51,11,0,1
"DPP4",17,9,8,0,1
"CCL25",2,1,1,0,1
"CCL3",13,12,1,0,1
"CCL4",8,3,5,0,1
"CCR3",15,5,10,0,1
"IL8",19,18,1,0,1
"CCL5",30,23,7,0,1
"PIGR",26,23,3,0,1
"SDC1",21,16,5,0,1
"SDC4",24,19,5,0,1
"CDC25A",73,67,6,0,1
"CDC25C",17,11,6,0,1
"GADD45G",36,21,15,0,1
"GTF2E2",22,18,4,0,1
"CDK9",43,31,12,0,1
"DVL3",47,43,4,0,1
"JAK1",72,41,31,0,1
"CD4",43,23,20,0,1
"PTK2B",49,23,26,0,1
"TXK",19,16,3,0,1
"PAFAH1B2",55,53,2,0,1
"VHL",33,27,6,0,1
"ITGB2",32,10,22,0,1
"ITGB1",79,48,31,0,1
"CD79B",9,5,4,0,1
"PTPRC",38,20,18,0,1
"CD2",13,8,5,0,1
"LAT",22,10,12,0,1
"CD247",20,6,14,0,1
"TRAF2",92,17,75,0,1
"TRAF3",43,30,13,0,1
"CD28",25,12,13,0,1
"GRAP2",43,30,13,0,1
"PIK3CG",23,17,6,0,1
"PKD2",28,26,2,0,1
"CD3E",15,11,4,0,1
"IL16",20,14,6,0,1
"LLGL1",17,16,1,0,1
"GNAI1",50,32,18,0,1
"ITGAV",41,31,10,0,1
"UBQLN1",38,29,9,0,1
"CD48",13,8,5,0,1
"IL2",9,7,2,0,1
"IL4",4,2,2,0,1
"SDCBP",45,38,7,0,1
"CD81",25,20,5,0,1
"ITGA4",21,16,5,0,1
"HLA-DRA",13,10,3,0,1
"CD8A",12,6,6,0,1
"CD8B",2,1,1,0,1
"COL4A3",31,23,8,0,1
"MAPK14",85,72,13,0,1
"MELK",53,52,1,0,1
"SAFB",25,19,6,0,1
"ITSN1",52,43,9,0,1
"PARD6A",16,7,9,0,1
"TNK2",30,28,2,0,1
"CDC5L",53,52,1,0,1
"ERBB2IP",34,32,2,0,1
"GRIN2D",26,17,9,0,1
"CDK5RAP1",6,4,2,0,1
"PAX6",29,22,7,0,1
"GATA2",195,22,173,0,1
"MYB",283,28,255,0,1
"SMARCC1",40,27,13,0,1
"SRF",189,34,155,0,1
"TAF9",27,19,8,0,1
"FOSL1",112,29,83,0,1
"FOSL2",130,65,65,0,1
"SPTBN4",27,20,7,0,1
"PIN1",59,39,20,0,1
"NEK2",16,8,8,0,1
"PRKG1",51,35,16,0,1
"PPP2R5A",26,21,5,0,1
"CHFR",11,7,4,0,1
"CHGB",10,5,5,0,1
"POLR2E",28,24,4,0,1
"CHM",10,9,1,0,1
"CHMP1B",28,26,2,0,1
"CHMP2A",10,8,2,0,1
"CHMP4A",6,3,3,0,1
"MAPK8IP2",32,20,12,0,1
"GNA15",10,5,5,0,1
"CIB1",12,9,3,0,1
"WWP1",33,29,4,0,1
"GADD45A",37,25,12,0,1
"TYROBP",8,6,2,0,1
"CLIC4",53,51,2,0,1
"DRD3",5,1,4,0,1
"HGS",37,18,19,0,1
"MEST",9,6,3,0,1
"RABAC1",43,29,14,0,1
"CNKSR1",6,4,2,0,1
"CNOT7",25,22,3,0,1
"MET",69,45,24,0,1
"HN1L",19,18,1,0,1
"KCNA2",13,10,3,0,1
"COG4",3,2,1,0,1
"PPL",25,22,3,0,1
"FBLN2",22,17,5,0,1
"KDR",53,30,23,0,1
"IGFBP3",34,26,8,0,1
"COL2A1",18,11,7,0,1
"OSM",13,12,1,0,1
"COL4A3BP",48,46,2,0,1
"PXN",52,28,24,0,1
"XRN2",18,12,6,0,1
"COPS3",21,15,6,0,1
"POLA2",48,38,10,0,1
"RPA1",34,18,16,0,1
"MAPK11",12,10,2,0,1
"PDX1",15,4,11,0,1
"SMARCA5",34,32,2,0,1
"DACH1",34,29,5,0,1
"EBF1",208,34,174,0,1
"ETS1",202,67,135,0,1
"GATA1",319,6,313,0,1
"HOXB7",7,5,2,0,1
"MAFG",42,36,6,0,1
"NCOA6",38,30,8,0,1
"NFATC2",41,30,11,0,1
"PPARG",110,22,88,0,1
"PROX1",43,35,8,0,1
"SNIP1",46,41,5,0,1
"SREBF1",60,35,25,0,1
"THRA",80,69,11,0,1
"TP53",111,21,90,0,1
"TUBB2A",43,40,3,0,1
"IRS2",46,39,7,0,1
"CRKL",85,62,23,0,1
"EVL",18,14,4,0,1
"GAB2",23,17,6,0,1
"SNRNP70",22,18,4,0,1
"INPP5D",18,9,9,0,1
"CSF2RB",19,8,11,0,1
"FES",13,9,4,0,1
"IL3",4,1,3,0,1
"PPP1R8",21,15,6,0,1
"ERCC8",8,6,2,0,1
"POLR2B",24,23,1,0,1
"CTGF",45,43,2,0,1
"NOV",13,8,5,0,1
"RUVBL1",14,13,1,0,1
"SHBG",12,4,8,0,1
"GP1BA",7,5,2,0,1
"LGALS3",19,15,4,0,1
"SATB1",45,39,6,0,1
"NCF4",6,5,1,0,1
"FMR1",35,33,2,0,1
"TRIM23",38,32,6,0,1
"ITGB5",31,15,16,0,1
"SIX1",21,19,2,0,1
"DAG1",31,25,6,0,1
"MCM7",65,54,11,0,1
"RPGR",5,4,1,0,1
"SNAPIN",20,15,5,0,1
"EIF3E",27,21,6,0,1
"RAC1",74,42,32,0,1
"MAP4K2",19,14,5,0,1
"SRRM1",12,8,4,0,1
"HSPD1",49,40,9,0,1
"PTCH1",24,23,1,0,1
"ILF3",37,35,2,0,1
"PSMA1",20,11,9,0,1
"DLG1",56,18,38,0,1
"DLGAP1",15,8,7,0,1
"GNG13",5,4,1,0,1
"KCNJ12",28,26,2,0,1
"MAPK12",16,7,9,0,1
"DLG2",52,29,23,0,1
"NOS1",18,11,7,0,1
"DLG3",38,20,18,0,1
"DLST",12,10,2,0,1
"DYNLL2",53,51,2,0,1
"DLGAP4",23,20,3,0,1
"FLII",14,10,4,0,1
"SOX10",25,12,13,0,1
"SOX8",18,12,6,0,1
"RPS10",16,12,4,0,1
"HMGCL",5,4,1,0,1
"NUDT3",93,77,16,0,1
"DNAJC3",26,23,3,0,1
"HSPA1B",26,24,2,0,1
"MPHOSPH6",18,13,5,0,1
"DNMBP",22,18,4,0,1
"TRIM27",31,27,4,0,1
"KIAA1279",29,25,4,0,1
"DPPA2",7,4,3,0,1
"KRT5",7,3,4,0,1
"DUSP1",47,44,3,0,1
"DUSP23",15,9,6,0,1
"PRPF3",7,4,3,0,1
"PNN",19,14,5,0,1
"PARD3",36,26,10,0,1
"MBP",29,9,20,0,1
"E2F6",249,28,221,0,1
"E2F3",227,118,109,0,1
"ECH1",12,7,5,0,1
"KLHL20",26,21,5,0,1
"RHOG",22,17,5,0,1
"EDA",6,5,1,0,1
"FURIN",25,16,9,0,1
"RAB5C",25,24,1,0,1
"EXOSC4",20,9,11,0,1
"RFC5",17,13,4,0,1
"RPA2",27,19,8,0,1
"MVD",6,5,1,0,1
"EFNA1",33,29,4,0,1
"PRSS23",33,25,8,0,1
"EFNA5",46,45,1,0,1
"EPHB2",36,27,9,0,1
"PTPN13",26,21,5,0,1
"RGS3",16,12,4,0,1
"HOMER1",34,25,9,0,1
"SNRPD2",20,9,11,0,1
"UPF2",29,18,11,0,1
"NPM1",37,29,8,0,1
"GSK3A",21,20,1,0,1
"EIF3F",20,16,4,0,1
"FUNDC2",11,9,2,0,1
"GNB2L1",47,37,10,0,1
"ID2",27,19,8,0,1
"ELN",21,19,2,0,1
"ENAH",52,43,9,0,1
"TES",46,41,5,0,1
"TUBA1A",26,15,11,0,1
"ING4",8,6,2,0,1
"NUMA1",16,14,2,0,1
"EPHA4",45,36,9,0,1
"STUB1",19,6,13,0,1
"FLI1",249,29,220,0,1
"PSMC5",27,25,2,0,1
"ETF1",21,20,1,0,1
"GATA3",397,23,374,0,1
"EXOC7",24,19,5,0,1
"RAB27A",27,19,8,0,1
"TJP1",54,41,13,0,1
"PLAU",18,14,4,0,1
"PROC",6,4,2,0,1
"SERPINC1",15,13,2,0,1
"RAP1A",52,35,17,0,1
"FANCD2",21,15,6,0,1
"PLAUR",17,7,10,0,1
"TNFRSF1A",43,20,23,0,1
"FCER1G",11,4,7,0,1
"FCGR1A",6,2,4,0,1
"ZAP70",35,4,31,0,1
"FGFR1",49,40,9,0,1
"HSPA9",27,24,3,0,1
"SYT1",41,34,7,0,1
"RPS6KA3",95,84,11,0,1
"ICAM1",25,22,3,0,1
"FIGF",5,3,2,0,1
"NPHP1",14,10,4,0,1
"FLNB",25,22,3,0,1
"KRAS",36,27,9,0,1
"FOXA2",141,3,138,0,1
"NR1H3",35,11,24,0,1
"TAF10",23,12,11,0,1
"SNAP23",36,29,7,0,1
"SLC35E1",14,12,2,0,1
"TYK2",23,12,11,0,1
"MAGI3",28,26,2,0,1
"WNT1",21,18,3,0,1
"GABARAP",18,11,7,0,1
"GABBR1",15,13,2,0,1
"GRASP",11,7,4,0,1
"GAS1",27,25,2,0,1
"GATA4",25,5,20,0,1
"JARID2",47,28,19,0,1
"MBD3",265,33,232,0,1
"GBP2",13,6,7,0,1
"NCAM1",20,14,6,0,1
"RIBC2",12,4,8,0,1
"RET",30,16,14,0,1
"GGA1",31,23,8,0,1
"GGA2",34,24,10,0,1
"GHRL",5,1,4,0,1
"NTRK1",18,5,13,0,1
"RGS19",20,12,8,0,1
"ZIC1",11,8,3,0,1
"NUDT18",22,15,7,0,1
"PLEKHF2",39,37,2,0,1
"TRPC3",21,14,7,0,1
"GNB1",34,25,9,0,1
"PPP2R1A",31,27,4,0,1
"RGS12",12,7,5,0,1
"RGS20",3,2,1,0,1
"RGS4",19,14,5,0,1
"GNAI3",38,26,12,0,1
"OPRM1",4,2,2,0,1
"PABPC1",68,57,11,0,1
"GOLGA2",40,28,12,0,1
"GOLGA3",12,9,3,0,1
"STX6",45,40,5,0,1
"IGF2",62,55,7,0,1
"LRSAM1",16,10,6,0,1
"STMN2",16,13,3,0,1
"NGFR",51,31,20,0,1
"USP8",24,22,2,0,1
"VAV3",109,101,8,0,1
"WASL",69,58,11,0,1
"MAP2K2",19,12,7,0,1
"TUBA1B",40,38,2,0,1
"SGK1",45,41,4,0,1
"TAF1C",13,9,4,0,1
"HAND2",57,26,31,0,1
"TCF3",241,26,215,0,1
"MMP2",56,35,21,0,1
"MED25",8,5,3,0,1
"SPOP",28,26,2,0,1
"ID1",19,15,4,0,1
"ID3",34,28,6,0,1
"NR4A1",41,12,29,0,1
"HEXDC",6,3,3,0,1
"SMAD7",60,46,14,0,1
"HHIP",45,43,2,0,1
"HIPK2",38,32,6,0,1
"HLA-B",20,14,6,0,1
"HLA-C",21,13,8,0,1
"HSPA5",48,31,17,0,1
"NR1H2",45,10,35,0,1
"SEPT2",4,1,3,0,1
"TNPO1",79,74,5,0,1
"MARS",31,30,1,0,1
"PKNOX1",31,28,3,0,1
"MEIS1",46,36,10,0,1
"PBX1",180,49,131,0,1
"HOXC8",31,29,2,0,1
"SMAD6",18,15,3,0,1
"NUAK1",46,37,9,0,1
"UBC",16,12,4,0,1
"HTRA1",17,11,6,0,1
"ICAM4",4,3,1,0,1
"IDH3B",6,5,1,0,1
"IFNAR1",38,30,8,0,1
"IGF1",92,90,2,0,1
"IGFBP5",52,45,7,0,1
"RANBP10",10,8,2,0,1
"IL12B",4,3,1,0,1
"IL4R",19,8,11,0,1
"IL2RB",18,6,12,0,1
"IL18",8,5,3,0,1
"IL1RAP",35,27,8,0,1
"TICAM2",12,6,6,0,1
"IL21",2,1,1,0,1
"PTPN6",65,13,52,0,1
"IL7R",19,11,8,0,1
"LIMS1",38,33,5,0,1
"NUP62",37,34,3,0,1
"NLRP12",6,5,1,0,1
"TRAF4",19,13,6,0,1
"IRF3",31,16,15,0,1
"TLN1",60,53,7,0,1
"ITGB7",12,3,9,0,1
"ITGA5",41,27,14,0,1
"LTB",10,8,2,0,1
"VTN",12,3,9,0,1
"PPIA",32,27,5,0,1
"PGR",160,32,128,0,1
"POLR3F",23,20,3,0,1
"VTA1",44,38,6,0,1
"KHSRP",66,59,7,0,1
"KISS1",2,1,1,0,1
"PEA15",12,11,1,0,1
"LAMA2",6,5,1,0,1
"STOM",16,15,1,0,1
"LRPAP1",32,29,3,0,1
"LEF1",32,17,15,0,1
"SHANK2",30,27,3,0,1
"LRP10",39,38,1,0,1
"LRP12",37,33,4,0,1
"LRRC41",15,14,1,0,1
"LSM2",10,3,7,0,1
"LSM4",20,14,6,0,1
"LSM5",13,9,4,0,1
"SNRPD3",42,34,8,0,1
"LSM7",15,4,11,0,1
"TRAF5",27,20,7,0,1
"PTCD3",29,28,1,0,1
"NDN",19,14,5,0,1
"MED12",12,10,2,0,1
"MACF1",30,27,3,0,1
"MAP3K2",61,59,2,0,1
"MAP2K6",29,25,4,0,1
"MAP3K5",42,26,16,0,1
"PHC2",26,21,5,0,1
"MAPK8IP3",32,19,13,0,1
"ZNF512B",50,40,10,0,1
"POMC",8,5,3,0,1
"RPL18A",24,20,4,0,1
"MESDC2",22,19,3,0,1
"SPOCK3",11,10,1,0,1
"TUBB3",15,9,6,0,1
"MTA1",24,19,5,0,1
"OSGEP",11,3,8,0,1
"ZFHX3",79,78,1,0,1
"RAB11A",48,45,3,0,1
"PNKP",6,4,2,0,1
"NEDD8",15,8,7,0,1
"NAGK",24,16,8,0,1
"NR1D2",31,29,2,0,1
"PSMD4",11,9,2,0,1
"SDCBP2",7,2,5,0,1
"TLX1",44,21,23,0,1
"SMPD1",13,10,3,0,1
"NKX2-1",19,3,16,0,1
"GATA6",129,90,39,0,1
"NLGN3",12,9,3,0,1
"WDYHV1",16,8,8,0,1
"SFPQ",175,56,119,0,1
"SYN1",10,7,3,0,1
"NPPA",4,2,2,0,1
"NR4A3",25,24,1,0,1
"SIX3",28,25,3,0,1
"STX4",27,20,7,0,1
"NUP98",33,27,6,0,1
"RANBP2",46,35,11,0,1
"P2RY1",23,20,3,0,1
"BACH2",78,61,17,0,1
"WT1",22,18,4,0,1
"PBX2",13,10,3,0,1
"YBX1",37,32,5,0,1
"PDGFRB",43,20,23,0,1
"SCMH1",8,5,3,0,1
"TICAM1",15,8,7,0,1
"PLA2G10",4,3,1,0,1
"RND1",7,4,3,0,1
"PPFIA3",8,4,4,0,1
"WBP11",25,19,6,0,1
"PRKAR1B",11,10,1,0,1
"PTAFR",15,12,3,0,1
"PTGDS",9,4,5,0,1
"PTGFR",15,13,2,0,1
"PVR",38,35,3,0,1
"RAB3A",9,5,4,0,1
"RAB5B",68,64,4,0,1
"VAMP2",25,22,3,0,1
"RBM8A",35,33,2,0,1
"RFX2",9,7,2,0,1
"RFX3",28,26,2,0,1
"RNF216",19,15,4,0,1
"SCARB1",18,14,4,0,1
"SMAD5",67,57,10,0,1
"SOX5",37,35,2,0,1
"ZNF76",31,12,19,0,1
"ZNF83",25,17,8,0,1
"SMG5",13,12,1,0,1
"UPF1",20,14,6,0,1
"TCEB2",14,8,6,0,1
"TCEB1",49,45,4,0,1
"SOX6",56,55,1,0,1
"NKX3-1",32,16,16,0,1
"SPOCK2",12,11,1,0,1
"STAT4",14,4,10,0,1
"TCF7L2",156,50,106,0,1
"YEATS4",11,10,1,0,1
"TM4SF1",22,18,4,0,1
"TNFRSF10A",19,8,11,0,1
"TNFSF10",11,10,1,0,1
"TNFRSF10B",40,34,6,0,1
"TNFSF12",4,3,1,0,1
"TNFRSF4",7,1,6,0,1
"TNFSF14",11,9,2,0,1
"TNPO2",31,30,1,0,1
"TYRO3",26,22,4,0,1
"UBD",4,3,1,0,1
"ZBTB43",33,31,2,0,1
"ZNF417",34,32,2,0,1
"ZNF165",3,2,1,0,1
"ZNF250",15,12,3,0,1
"KLF2",50,46,4,0,1
"ASH2L",9,6,3,0,1
"hsa-miR-130a-5p",749,26,723,0,1
"hsa-miR-141-5p",432,44,388,0,1
"hsa-miR-142-5p",651,38,613,0,1
"hsa-miR-181a-5p",657,42,615,0,1
"hsa-miR-214-5p",225,20,205,0,1
"hsa-miR-222-5p",329,15,314,0,1
"hsa-miR-223-5p",215,33,182,0,1
"hsa-miR-23a-5p",802,53,749,0,1
"hsa-miR-338-5p",231,17,214,0,1
"hsa-miR-342-5p",314,35,279,0,1
"hsa-miR-3614-5p",110,66,44,0,1
"hsa-miR-3648",123,119,4,0,1
"hsa-miR-429",337,22,315,0,1
"hsa-miR-4473",33,23,10,0,1
"hsa-miR-4757-5p",10,8,2,0,1
"hsa-miR-663a",116,88,28,0,1
"hsa-miR-9-5p",692,50,642,0,1
